trade_id,PL,closeVWAP_timestamp,closedWhen,closedWhenUnixTimeStamp,closing_price_VWAP,expir,instrument,long_or_short,markToMarket_time,openVWAP_timestamp,open_or_closed,openedWhen,opening_price_VWAP,ptValue,putcall,quant_closed,quant_opened,strike,symbol,symbol_description,PurePL,qty,balance,commission,margin_available,purebalance
1.0,-1489140.75,20160322 07:33:53 EST,20160322 07:33:53 EST,20160322 07:33:53 EST,28994.85,,BTCUSD,long,,20160322 07:20:16 EST,closed,20160322 07:20:16 EST,28998.78,,,1.0,1.0,,BTCUSD,,-39300.0,-1.0,-1469140.75,1449840.75,360700.0,-19300.0
2.0,-1556709.25,20160322 07:49:17 EST,20160322 07:49:17 EST,20160322 07:49:17 EST,29005.52,,BTCUSD,short,,20160322 07:33:53 EST,closed,20160322 07:33:53 EST,28994.85,,,1.0,1.0,,BTCUSD,,-106700.0,1.0,-3025850.0,1450009.25,467400.0,-126000.0
3.0,-1644888.25,20160322 08:19:49 EST,20160322 08:19:49 EST,20160322 08:19:49 EST,28986.01,,BTCUSD,long,,20160322 07:49:17 EST,closed,20160322 07:49:17 EST,29005.52,,,1.0,1.0,,BTCUSD,,-195100.0,-1.0,-4670738.25,1449788.25,272300.0,-321100.0
4.0,1060759.0,20160322 09:02:42 EST,20160322 09:02:42 EST,20160322 09:02:42 EST,28735.63,,BTCUSD,short,,20160322 08:19:49 EST,closed,20160322 08:19:49 EST,28986.01,,,1.0,1.0,,BTCUSD,,2503800.0,1.0,-3609979.25,1443041.0,-2231500.0,2182700.0
5.0,-12754715.75,20160322 09:47:21 EST,20160322 09:47:21 EST,20160322 09:47:21 EST,27601.0,,BTCUSD,long,,20160322 09:02:42 EST,closed,20160322 09:02:42 EST,28735.63,,,1.0,1.0,,BTCUSD,,-11346300.0,-1.0,-16364695.0,1408415.75,-13577800.0,-9163600.0
6.0,-16467975.75,20160322 10:34:42 EST,20160322 10:34:42 EST,20160322 10:34:42 EST,29106.03,,BTCUSD,short,,20160322 09:47:21 EST,closed,20160322 09:47:21 EST,27601.0,,,1.0,1.0,,BTCUSD,,-15050300.0,1.0,-32832670.75,1417675.75,1472500.0,-24213900.0
7.0,1119146.25,20160322 10:45:48 EST,20160322 10:45:48 EST,20160322 10:45:48 EST,29364.12,,BTCUSD,long,,20160322 10:34:42 EST,closed,20160322 10:34:42 EST,29106.03,,,1.0,1.0,,BTCUSD,,2580900.0,-1.0,-31713524.5,1461753.75,4053400.0,-21633000.0
8.0,20799925.5,20160322 11:31:31 EST,20160322 11:31:31 EST,20160322 11:31:31 EST,27142.86,,BTCUSD,short,,20160322 10:45:48 EST,closed,20160322 10:45:48 EST,29364.12,,,1.0,1.0,,BTCUSD,,22212600.0,1.0,-10913599.0,1412674.5,-18159200.0,579600.0
9.0,17076357.75,20160322 12:01:43 EST,20160322 12:01:43 EST,20160322 12:01:43 EST,28990.83,,BTCUSD,long,,20160322 11:31:31 EST,closed,20160322 11:31:31 EST,27142.86,,,1.0,1.0,,BTCUSD,,18479700.0,-1.0,6162758.75,1403342.25,320500.0,19059300.0
10.0,-1757609.75,20160322 12:47:00 EST,20160322 12:47:00 EST,20160322 12:47:00 EST,29021.56,,BTCUSD,short,,20160322 12:01:43 EST,closed,20160322 12:01:43 EST,28990.83,,,1.0,1.0,,BTCUSD,,-307300.0,1.0,4405149.0,1450309.75,627800.0,18752000.0
11.0,8308861.0,20160322 13:15:58 EST,20160322 13:15:58 EST,20160322 13:15:58 EST,30000.0,,BTCUSD,long,,20160322 12:47:00 EST,closed,20160322 12:47:00 EST,29021.56,,,1.0,1.0,,BTCUSD,,9784400.0,-1.0,12714010.0,1475539.0,10412200.0,28536400.0
12.0,28304024.25,20160322 13:31:26 EST,20160322 13:31:26 EST,20160322 13:31:26 EST,27027.03,,BTCUSD,short,,20160322 13:15:58 EST,closed,20160322 13:15:58 EST,30000.0,,,1.0,1.0,,BTCUSD,,29729700.0,1.0,41018034.25,1425675.75,-19317500.0,58266100.0
13.0,15243357.75,20160322 14:16:26 EST,20160322 14:16:26 EST,20160322 14:16:26 EST,28690.66,,BTCUSD,long,,20160322 13:31:26 EST,closed,20160322 13:31:26 EST,27027.03,,,1.0,1.0,,BTCUSD,,16636300.0,-1.0,56261392.0,1392942.25,-2681200.0,74902400.0
14.0,-4390404.25,20160322 15:47:53 EST,20160322 15:47:53 EST,20160322 15:47:53 EST,28985.51,,BTCUSD,short,,20160322 14:16:26 EST,closed,20160322 14:16:26 EST,28690.66,,,1.0,1.0,,BTCUSD,,-2948500.0,1.0,51870987.75,1441904.25,267300.0,71953900.0
15.0,-3234102.25,20160322 16:02:06 EST,20160322 16:02:06 EST,20160322 16:02:06 EST,28806.58,,BTCUSD,long,,20160322 15:47:53 EST,closed,20160322 15:47:53 EST,28985.51,,,1.0,1.0,,BTCUSD,,-1789300.0,-1.0,48636885.5,1444802.25,-1522000.0,70164600.0
16.0,-2685835.0,20160322 17:03:10 EST,20160322 17:03:10 EST,20160322 17:03:10 EST,28930.82,,BTCUSD,short,,20160322 16:02:06 EST,closed,20160322 16:02:06 EST,28806.58,,,1.0,1.0,,BTCUSD,,-1242400.0,1.0,45951050.5,1443435.0,-279600.0,68922200.0
17.0,2078025.5,20160322 17:16:14 EST,20160322 17:16:14 EST,20160322 17:16:14 EST,29284.16,,BTCUSD,long,,20160322 17:03:10 EST,closed,20160322 17:03:10 EST,28930.82,,,1.0,1.0,,BTCUSD,,3533400.0,-1.0,48029076.0,1455374.5,3253800.0,72455600.0
18.0,3691850.0,20160322 18:02:01 EST,20160322 18:02:01 EST,20160322 18:02:01 EST,28769.84,,BTCUSD,short,,20160322 17:16:14 EST,closed,20160322 17:16:14 EST,29284.16,,,1.0,1.0,,BTCUSD,,5143200.0,1.0,51720926.0,1451350.0,-1889400.0,77598800.0
19.0,10939286.0,20160322 19:01:14 EST,20160322 19:01:14 EST,20160322 19:01:14 EST,30010.72,,BTCUSD,long,,20160322 18:02:01 EST,closed,20160322 18:02:01 EST,28769.84,,,1.0,1.0,,BTCUSD,,12408800.0,-1.0,62660212.0,1469514.0,10519400.0,90007600.0
20.0,8633836.75,20160322 19:16:10 EST,20160322 19:16:10 EST,20160322 19:16:10 EST,28999.81,,BTCUSD,short,,20160322 19:01:14 EST,closed,20160322 19:01:14 EST,30010.72,,,1.0,1.0,,BTCUSD,,10109100.0,1.0,71294048.75,1475263.25,410300.0,100116700.0
21.0,-189150.5,20160322 19:34:49 EST,20160322 19:34:49 EST,20160322 19:34:49 EST,29126.21,,BTCUSD,long,,20160322 19:16:10 EST,closed,20160322 19:16:10 EST,28999.81,,,1.0,1.0,,BTCUSD,,1264000.0,-1.0,71104898.25,1453150.5,1674300.0,101380700.0
22.0,831494.75,20160322 19:46:17 EST,20160322 19:46:17 EST,20160322 19:46:17 EST,28898.0,,BTCUSD,short,,20160322 19:34:49 EST,closed,20160322 19:34:49 EST,29126.21,,,1.0,1.0,,BTCUSD,,2282100.0,1.0,71936393.0,1450605.25,-607800.0,103662800.0
23.0,-631039.75,20160322 20:35:44 EST,20160322 20:35:44 EST,20160322 20:35:44 EST,28979.59,,BTCUSD,long,,20160322 19:46:17 EST,closed,20160322 19:46:17 EST,28898.0,,,1.0,1.0,,BTCUSD,,815900.0,-1.0,71305353.25,1446939.75,208100.0,104478700.0
24.0,-596954.75,20160322 21:02:23 EST,20160322 21:02:23 EST,20160322 21:02:23 EST,28894.6,,BTCUSD,short,,20160322 20:35:44 EST,closed,20160322 20:35:44 EST,28979.59,,,1.0,1.0,,BTCUSD,,849900.0,1.0,70708398.5,1446854.75,-641800.0,105328600.0
25.0,7206587.5,20160322 21:15:45 EST,20160322 21:15:45 EST,20160322 21:15:45 EST,29761.9,,BTCUSD,long,,20160322 21:02:23 EST,closed,20160322 21:02:23 EST,28894.6,,,1.0,1.0,,BTCUSD,,8673000.0,-1.0,77914986.0,1466412.5,8031200.0,114001600.0
26.0,-1769897.75,20160322 21:32:54 EST,20160322 21:32:54 EST,20160322 21:32:54 EST,29790.01,,BTCUSD,short,,20160322 21:15:45 EST,closed,20160322 21:15:45 EST,29761.9,,,1.0,1.0,,BTCUSD,,-281100.0,1.0,76145088.25,1488797.75,8312300.0,113720500.0
27.0,10580149.75,20160322 21:48:25 EST,20160322 21:48:25 EST,20160322 21:48:25 EST,31000.0,,BTCUSD,long,,20160322 21:32:54 EST,closed,20160322 21:32:54 EST,29790.01,,,1.0,1.0,,BTCUSD,,12099900.0,-1.0,86725238.0,1519750.25,20412200.0,125820400.0
28.0,19485156.75,20160322 22:17:14 EST,20160322 22:17:14 EST,20160322 22:17:14 EST,28901.73,,BTCUSD,short,,20160322 21:48:25 EST,closed,20160322 21:48:25 EST,31000.0,,,1.0,1.0,,BTCUSD,,20982700.0,1.0,106210394.75,1497543.25,-570500.0,146803100.0
29.0,7528323.75,20160322 22:48:20 EST,20160322 22:48:20 EST,20160322 22:48:20 EST,29801.32,,BTCUSD,long,,20160322 22:17:14 EST,closed,20160322 22:17:14 EST,28901.73,,,1.0,1.0,,BTCUSD,,8995900.0,-1.0,113738718.5,1467576.25,8425400.0,155799000.0
30.0,7695641.0,20160322 23:01:54 EST,20160322 23:01:54 EST,20160322 23:01:54 EST,28885.04,,BTCUSD,short,,20160322 22:48:20 EST,closed,20160322 22:48:20 EST,29801.32,,,1.0,1.0,,BTCUSD,,9162800.0,1.0,121434359.5,1467159.0,-737400.0,164961800.0
31.0,7081779.5,20160322 23:17:23 EST,20160322 23:17:23 EST,20160322 23:17:23 EST,29739.78,,BTCUSD,long,,20160322 23:01:54 EST,closed,20160322 23:01:54 EST,28885.04,,,1.0,1.0,,BTCUSD,,8547400.0,-1.0,128516139.0,1465620.5,7810000.0,173509200.0
32.0,3953578.5,20160323 00:04:35 EST,20160323 00:04:35 EST,20160323 00:04:35 EST,29197.08,,BTCUSD,short,,20160322 23:17:23 EST,closed,20160322 23:17:23 EST,29739.78,,,1.0,1.0,,BTCUSD,,5427000.0,1.0,132469717.5,1473421.5,2383000.0,178936200.0
33.0,4373226.75,20160323 00:18:45 EST,20160323 00:18:45 EST,20160323 00:18:45 EST,29781.85,,BTCUSD,long,,20160323 00:04:35 EST,closed,20160323 00:04:35 EST,29197.08,,,1.0,1.0,,BTCUSD,,5847700.0,-1.0,136842944.25,1474473.25,8230700.0,184783900.0
34.0,23391453.75,20160323 00:32:56 EST,20160323 00:32:56 EST,20160323 00:32:56 EST,27300.0,,BTCUSD,short,,20160323 00:18:45 EST,closed,20160323 00:18:45 EST,29781.85,,,1.0,1.0,,BTCUSD,,24818500.0,1.0,160234398.0,1427046.25,-16587800.0,209602400.0
35.0,17576727.0,20160323 00:48:17 EST,20160323 00:48:17 EST,20160323 00:48:17 EST,29198.92,,BTCUSD,long,,20160323 00:32:56 EST,closed,20160323 00:32:56 EST,27300.0,,,1.0,1.0,,BTCUSD,,18989200.0,-1.0,177811125.0,1412473.0,2401400.0,228591600.0
36.0,14019155.25,20160323 01:01:26 EST,20160323 01:01:26 EST,20160323 01:01:26 EST,27654.87,,BTCUSD,short,,20160323 00:48:17 EST,closed,20160323 00:48:17 EST,29198.92,,,1.0,1.0,,BTCUSD,,15440500.0,1.0,191830280.25,1421344.75,-13039100.0,244032100.0
37.0,19723359.0,20160323 01:47:44 EST,20160323 01:47:44 EST,20160323 01:47:44 EST,29770.77,,BTCUSD,long,,20160323 01:01:26 EST,closed,20160323 01:01:26 EST,27654.87,,,1.0,1.0,,BTCUSD,,21159000.0,-1.0,211553639.25,1435641.0,8119900.0,265191100.0
38.0,7780777.0,20160323 02:01:06 EST,20160323 02:01:06 EST,20160323 02:01:06 EST,28846.15,,BTCUSD,short,,20160323 01:47:44 EST,closed,20160323 01:47:44 EST,29770.77,,,1.0,1.0,,BTCUSD,,9246200.0,1.0,219334416.25,1465423.0,-1126300.0,274437300.0
39.0,7594244.5,20160323 02:16:34 EST,20160323 02:16:34 EST,20160323 02:16:34 EST,29752.07,,BTCUSD,long,,20160323 02:01:06 EST,closed,20160323 02:01:06 EST,28846.15,,,1.0,1.0,,BTCUSD,,9059200.0,-1.0,226928660.75,1464955.5,7932900.0,283496500.0
40.0,338751.0,20160323 03:02:03 EST,20160323 03:02:03 EST,20160323 03:02:03 EST,29569.89,,BTCUSD,short,,20160323 02:16:34 EST,closed,20160323 02:16:34 EST,29752.07,,,1.0,1.0,,BTCUSD,,1821800.0,1.0,227267411.75,1483049.0,6111100.0,285318300.0
41.0,-2390508.75,20160323 03:18:10 EST,20160323 03:18:10 EST,20160323 03:18:10 EST,29478.46,,BTCUSD,long,,20160323 03:02:03 EST,closed,20160323 03:02:03 EST,29569.89,,,1.0,1.0,,BTCUSD,,-914300.0,-1.0,224876903.0,1476208.75,5196800.0,284404000.0
42.0,-520746.0,20160323 03:31:45 EST,20160323 03:31:45 EST,20160323 03:31:45 EST,29383.38,,BTCUSD,short,,20160323 03:18:10 EST,closed,20160323 03:18:10 EST,29478.46,,,1.0,1.0,,BTCUSD,,950800.0,1.0,224356157.0,1471546.0,4246000.0,285354800.0
43.0,-4290597.75,20160323 04:03:39 EST,20160323 04:03:39 EST,20160323 04:03:39 EST,29100.53,,BTCUSD,long,,20160323 03:31:45 EST,closed,20160323 03:31:45 EST,29383.38,,,1.0,1.0,,BTCUSD,,-2828500.0,-1.0,220065559.25,1462097.75,1417500.0,282526300.0
44.0,-386161.0,20160323 05:17:48 EST,20160323 05:17:48 EST,20160323 05:17:48 EST,28993.91,,BTCUSD,short,,20160323 04:03:39 EST,closed,20160323 04:03:39 EST,29100.53,,,1.0,1.0,,BTCUSD,,1066200.0,1.0,219679398.25,1452361.0,351300.0,283592500.0
45.0,-2369191.0,20160323 05:45:54 EST,20160323 05:45:54 EST,20160323 05:45:54 EST,28901.73,,BTCUSD,long,,20160323 05:17:48 EST,closed,20160323 05:17:48 EST,28993.91,,,1.0,1.0,,BTCUSD,,-921800.0,-1.0,217310207.25,1447391.0,-570500.0,282670700.0
46.0,-887897.0,20160323 06:02:49 EST,20160323 06:02:49 EST,20160323 06:02:49 EST,28846.15,,BTCUSD,short,,20160323 05:45:54 EST,closed,20160323 05:45:54 EST,28901.73,,,1.0,1.0,,BTCUSD,,555800.0,1.0,216422310.25,1443697.0,-1126300.0,283226500.0
47.0,-52191.5,20160323 06:17:44 EST,20160323 06:17:44 EST,20160323 06:17:44 EST,28985.51,,BTCUSD,long,,20160323 06:02:49 EST,closed,20160323 06:02:49 EST,28846.15,,,1.0,1.0,,BTCUSD,,1393600.0,-1.0,216370118.75,1445791.5,267300.0,284620100.0
48.0,10658217.75,20160323 07:46:17 EST,20160323 07:46:17 EST,20160323 07:46:17 EST,27777.78,,BTCUSD,short,,20160323 06:17:44 EST,closed,20160323 06:17:44 EST,28985.51,,,1.0,1.0,,BTCUSD,,12077300.0,1.0,227028336.5,1419082.25,-11810000.0,296697400.0
49.0,11561753.25,20160323 08:02:14 EST,20160323 08:02:14 EST,20160323 08:02:14 EST,29076.09,,BTCUSD,long,,20160323 07:46:17 EST,closed,20160323 07:46:17 EST,27777.78,,,1.0,1.0,,BTCUSD,,12983100.0,-1.0,238590089.75,1421346.75,1173100.0,309680500.0
50.0,-545740.0,20160323 08:31:38 EST,20160323 08:31:38 EST,20160323 08:31:38 EST,28985.51,,BTCUSD,short,,20160323 08:02:14 EST,closed,20160323 08:02:14 EST,29076.09,,,1.0,1.0,,BTCUSD,,905800.0,1.0,238044349.75,1451540.0,267300.0,310586300.0
51.0,-3391607.5,20160323 09:01:20 EST,20160323 09:01:20 EST,20160323 09:01:20 EST,28790.79,,BTCUSD,long,,20160323 08:31:38 EST,closed,20160323 08:31:38 EST,28985.51,,,1.0,1.0,,BTCUSD,,-1947200.0,-1.0,234652742.25,1444407.5,-1679900.0,308639100.0
52.0,-4366639.0,20160323 09:17:41 EST,20160323 09:17:41 EST,20160323 09:17:41 EST,29082.77,,BTCUSD,short,,20160323 09:01:20 EST,closed,20160323 09:01:20 EST,28790.79,,,1.0,1.0,,BTCUSD,,-2919800.0,1.0,230286103.25,1446839.0,1239900.0,305719300.0
53.0,2651671.25,20160323 09:31:37 EST,20160323 09:31:37 EST,20160323 09:31:37 EST,29494.38,,BTCUSD,long,,20160323 09:17:41 EST,closed,20160323 09:17:41 EST,29082.77,,,1.0,1.0,,BTCUSD,,4116100.0,-1.0,232937774.5,1464428.75,5356000.0,309835400.0
54.0,5301579.5,20160323 10:19:04 EST,20160323 10:19:04 EST,20160323 10:19:04 EST,28818.44,,BTCUSD,short,,20160323 09:31:37 EST,closed,20160323 09:31:37 EST,29494.38,,,1.0,1.0,,BTCUSD,,6759400.0,1.0,238239354.0,1457820.5,-1403400.0,316594800.0
55.0,2336012.0,20160323 11:02:03 EST,20160323 11:02:03 EST,20160323 11:02:03 EST,29197.08,,BTCUSD,long,,20160323 10:19:04 EST,closed,20160323 10:19:04 EST,28818.44,,,1.0,1.0,,BTCUSD,,3786400.0,-1.0,240575366.0,1450388.0,2383000.0,320381200.0
56.0,-9509127.0,20160323 11:19:45 EST,20160323 11:19:45 EST,20160323 11:19:45 EST,30000.0,,BTCUSD,short,,20160323 11:02:03 EST,closed,20160323 11:02:03 EST,29197.08,,,1.0,1.0,,BTCUSD,,-8029200.0,1.0,231066239.0,1479927.0,10412200.0,312352000.0
57.0,-8882497.5,20160323 11:32:13 EST,20160323 11:32:13 EST,20160323 11:32:13 EST,29259.9,,BTCUSD,long,,20160323 11:19:45 EST,closed,20160323 11:19:45 EST,30000.0,,,1.0,1.0,,BTCUSD,,-7401000.0,-1.0,222183741.5,1481497.5,3011200.0,304951000.0
58.0,-17399236.25,20160324 18:46:41 EST,20160324 18:46:41 EST,20160324 18:46:41 EST,30849.55,,BTCUSD,short,,20160323 11:32:13 EST,closed,20160323 11:32:13 EST,29259.9,,,1.0,1.0,,BTCUSD,,-15896500.0,1.0,204784505.25,1502736.25,18907700.0,289054500.0
59.0,-100092.5,20160324 19:01:57 EST,20160324 19:01:57 EST,20160324 19:01:57 EST,30994.15,,BTCUSD,long,,20160324 18:46:41 EST,closed,20160324 18:46:41 EST,30849.55,,,1.0,1.0,,BTCUSD,,1446000.0,-1.0,204684412.75,1546092.5,20353700.0,290500500.0
60.0,6344679.25,20160324 19:48:08 EST,20160324 19:48:08 EST,20160324 19:48:08 EST,30206.68,,BTCUSD,short,,20160324 19:01:57 EST,closed,20160324 19:01:57 EST,30994.15,,,1.0,1.0,,BTCUSD,,7874700.0,1.0,211029092.0,1530020.75,12479000.0,298375200.0
61.0,-1635819.5,20160324 20:16:26 EST,20160324 20:16:26 EST,20160324 20:16:26 EST,30194.1,,BTCUSD,long,,20160324 19:48:08 EST,closed,20160324 19:48:08 EST,30206.68,,,1.0,1.0,,BTCUSD,,-125800.0,-1.0,209393272.5,1510019.5,12353200.0,298249400.0
62.0,-1582286.0,20160324 20:31:44 EST,20160324 20:31:44 EST,20160324 20:31:44 EST,30201.34,,BTCUSD,short,,20160324 20:16:26 EST,closed,20160324 20:16:26 EST,30194.1,,,1.0,1.0,,BTCUSD,,-72400.0,1.0,207810986.5,1509886.0,12425600.0,298177000.0
63.0,8950316.5,20160324 21:02:10 EST,20160324 21:02:10 EST,20160324 21:02:10 EST,31250.0,,BTCUSD,long,,20160324 20:31:44 EST,closed,20160324 20:31:44 EST,30201.34,,,1.0,1.0,,BTCUSD,,10486600.0,-1.0,216761303.0,1536283.5,22912200.0,308663600.0
64.0,6078555.0,20160324 21:15:55 EST,20160324 21:15:55 EST,20160324 21:15:55 EST,30487.8,,BTCUSD,short,,20160324 21:02:10 EST,closed,20160324 21:02:10 EST,31250.0,,,1.0,1.0,,BTCUSD,,7622000.0,1.0,222839858.0,1543445.0,15290200.0,316285600.0
65.0,-3367470.75,20160324 21:32:30 EST,20160324 21:32:30 EST,20160324 21:32:30 EST,30303.03,,BTCUSD,long,,20160324 21:15:55 EST,closed,20160324 21:15:55 EST,30487.8,,,1.0,1.0,,BTCUSD,,-1847700.0,-1.0,219472387.25,1519770.75,13442500.0,314437900.0
66.0,2422267.5,20160324 21:47:20 EST,20160324 21:47:20 EST,20160324 21:47:20 EST,29910.27,,BTCUSD,short,,20160324 21:32:30 EST,closed,20160324 21:32:30 EST,30303.03,,,1.0,1.0,,BTCUSD,,3927600.0,1.0,221894654.75,1505332.5,9514900.0,318365500.0
67.0,7455951.75,20160324 22:45:49 EST,20160324 22:45:49 EST,20160324 22:45:49 EST,30807.66,,BTCUSD,long,,20160324 21:47:20 EST,closed,20160324 21:47:20 EST,29910.27,,,1.0,1.0,,BTCUSD,,8973900.0,-1.0,229350606.5,1517948.25,18488800.0,327339400.0
68.0,19231717.75,20160324 23:02:19 EST,20160324 23:02:19 EST,20160324 23:02:19 EST,28735.63,,BTCUSD,short,,20160324 22:45:49 EST,closed,20160324 22:45:49 EST,30807.66,,,1.0,1.0,,BTCUSD,,20720300.0,1.0,248582324.25,1488582.25,-2231500.0,348059700.0
69.0,27274759.75,20160324 23:15:55 EST,20160324 23:15:55 EST,20160324 23:15:55 EST,31613.98,,BTCUSD,long,,20160324 23:02:19 EST,closed,20160324 23:02:19 EST,28735.63,,,1.0,1.0,,BTCUSD,,28783500.0,-1.0,275857084.0,1508740.25,26552000.0,376843200.0
70.0,15751724.0,20160325 00:02:27 EST,20160325 00:02:27 EST,20160325 00:02:27 EST,29885.06,,BTCUSD,short,,20160324 23:15:55 EST,closed,20160324 23:15:55 EST,31613.98,,,1.0,1.0,,BTCUSD,,17289200.0,1.0,291608808.0,1537476.0,9262800.0,394132400.0
71.0,1342736.75,20160325 00:20:48 EST,20160325 00:20:48 EST,20160325 00:20:48 EST,30169.47,,BTCUSD,long,,20160325 00:02:27 EST,closed,20160325 00:02:27 EST,29885.06,,,1.0,1.0,,BTCUSD,,2844100.0,-1.0,292951544.75,1501363.25,12106900.0,396976500.0
72.0,3218013.25,20160325 01:16:05 EST,20160325 01:16:05 EST,20160325 01:16:05 EST,29698.0,,BTCUSD,short,,20160325 00:20:48 EST,closed,20160325 00:20:48 EST,30169.47,,,1.0,1.0,,BTCUSD,,4714700.0,1.0,296169558.0,1496686.75,7392200.0,401691200.0
73.0,6897092.5,20160325 01:31:34 EST,20160325 01:31:34 EST,20160325 01:31:34 EST,30538.3,,BTCUSD,long,,20160325 01:16:05 EST,closed,20160325 01:16:05 EST,29698.0,,,1.0,1.0,,BTCUSD,,8403000.0,-1.0,303066650.5,1505907.5,15795200.0,410094200.0
74.0,-105169.5,20160325 02:33:28 EST,20160325 02:33:28 EST,20160325 02:33:28 EST,30396.48,,BTCUSD,short,,20160325 01:31:34 EST,closed,20160325 01:31:34 EST,30538.3,,,1.0,1.0,,BTCUSD,,1418200.0,1.0,302961481.0,1523369.5,14377000.0,411512400.0
75.0,-440229.75,20160325 03:01:06 EST,20160325 03:01:06 EST,20160325 03:01:06 EST,30504.71,,BTCUSD,long,,20160325 02:33:28 EST,closed,20160325 02:33:28 EST,30396.48,,,1.0,1.0,,BTCUSD,,1082300.0,-1.0,302521251.25,1522529.75,15459300.0,412594700.0
76.0,127887.0,20160325 03:51:43 EST,20160325 03:51:43 EST,20160325 03:51:43 EST,30339.81,,BTCUSD,short,,20160325 03:01:06 EST,closed,20160325 03:01:06 EST,30504.71,,,1.0,1.0,,BTCUSD,,1649000.0,1.0,302649138.25,1521113.0,13810300.0,414243700.0
77.0,-2145315.75,20160325 04:01:42 EST,20160325 04:01:42 EST,20160325 04:01:42 EST,30276.82,,BTCUSD,long,,20160325 03:51:43 EST,closed,20160325 03:51:43 EST,30339.81,,,1.0,1.0,,BTCUSD,,-629900.0,-1.0,300503822.5,1515415.75,13180400.0,413613800.0
78.0,4544968.25,20160325 04:16:13 EST,20160325 04:16:13 EST,20160325 04:16:13 EST,29672.45,,BTCUSD,short,,20160325 04:01:42 EST,closed,20160325 04:01:42 EST,30276.82,,,1.0,1.0,,BTCUSD,,6043700.0,1.0,305048790.75,1498731.75,7136700.0,419657500.0
79.0,-14841344.5,20160325 05:32:05 EST,20160325 05:32:05 EST,20160325 05:32:05 EST,28333.33,,BTCUSD,long,,20160325 04:16:13 EST,closed,20160325 04:16:13 EST,29672.45,,,1.0,1.0,,BTCUSD,,-13391200.0,-1.0,290207446.25,1450144.5,-6254500.0,406266300.0
80.0,-20231887.25,20160325 06:16:25 EST,20160325 06:16:25 EST,20160325 06:16:25 EST,30210.16,,BTCUSD,short,,20160325 05:32:05 EST,closed,20160325 05:32:05 EST,28333.33,,,1.0,1.0,,BTCUSD,,-18768300.0,1.0,269975559.0,1463587.25,12513800.0,387498000.0
81.0,-1580033.75,20160325 06:32:17 EST,20160325 06:32:17 EST,20160325 06:32:17 EST,30203.19,,BTCUSD,long,,20160325 06:16:25 EST,closed,20160325 06:16:25 EST,30210.16,,,1.0,1.0,,BTCUSD,,-69700.0,-1.0,268395525.25,1510333.75,12444100.0,387428300.0
82.0,-1682990.5,20160325 07:33:07 EST,20160325 07:33:07 EST,20160325 07:33:07 EST,30220.43,,BTCUSD,short,,20160325 06:32:17 EST,closed,20160325 06:32:17 EST,30203.19,,,1.0,1.0,,BTCUSD,,-172400.0,1.0,266712534.75,1510590.5,12616500.0,387255900.0
83.0,-687086.5,20160325 07:47:15 EST,20160325 07:47:15 EST,20160325 07:47:15 EST,30303.03,,BTCUSD,long,,20160325 07:33:07 EST,closed,20160325 07:33:07 EST,30220.43,,,1.0,1.0,,BTCUSD,,826000.0,-1.0,266025448.25,1513086.5,13442500.0,388081900.0
84.0,4979645.0,20160325 08:01:18 EST,20160325 08:01:18 EST,20160325 08:01:18 EST,29655.17,,BTCUSD,short,,20160325 07:47:15 EST,closed,20160325 07:47:15 EST,30303.03,,,1.0,1.0,,BTCUSD,,6478600.0,1.0,271005093.25,1498955.0,6963900.0,394560500.0
85.0,-784408.75,20160325 08:17:22 EST,20160325 08:17:22 EST,20160325 08:17:22 EST,29725.18,,BTCUSD,long,,20160325 08:01:18 EST,closed,20160325 08:01:18 EST,29655.17,,,1.0,1.0,,BTCUSD,,700100.0,-1.0,270220684.5,1484508.75,7664000.0,395260600.0
86.0,785907.25,20160325 08:33:12 EST,20160325 08:33:12 EST,20160325 08:33:12 EST,29498.53,,BTCUSD,short,,20160325 08:17:22 EST,closed,20160325 08:17:22 EST,29725.18,,,1.0,1.0,,BTCUSD,,2266500.0,1.0,271006591.75,1480592.75,5397500.0,397527100.0
87.0,10258865.5,20160325 08:47:31 EST,20160325 08:47:31 EST,20160325 08:47:31 EST,30674.85,,BTCUSD,long,,20160325 08:33:12 EST,closed,20160325 08:33:12 EST,29498.53,,,1.0,1.0,,BTCUSD,,11763200.0,-1.0,281265457.25,1504334.5,17160700.0,409290300.0
88.0,770904.75,20160325 09:16:59 EST,20160325 09:16:59 EST,20160325 09:16:59 EST,30444.96,,BTCUSD,short,,20160325 08:47:31 EST,closed,20160325 08:47:31 EST,30674.85,,,1.0,1.0,,BTCUSD,,2298900.0,1.0,282036362.0,1527995.25,14861800.0,411589200.0
89.0,-982401.0,20160325 10:01:23 EST,20160325 10:01:23 EST,20160325 10:01:23 EST,30499.08,,BTCUSD,long,,20160325 09:16:59 EST,closed,20160325 09:16:59 EST,30444.96,,,1.0,1.0,,BTCUSD,,541200.0,-1.0,281053961.0,1523601.0,15403000.0,412130400.0
90.0,17799737.25,20160325 10:16:07 EST,20160325 10:16:07 EST,20160325 10:16:07 EST,28571.43,,BTCUSD,short,,20160325 10:01:23 EST,closed,20160325 10:01:23 EST,30499.08,,,1.0,1.0,,BTCUSD,,19276500.0,1.0,298853698.25,1476762.75,-3873500.0,431406900.0
91.0,19015789.5,20160325 10:31:02 EST,20160325 10:31:02 EST,20160325 10:31:02 EST,30620.99,,BTCUSD,long,,20160325 10:16:07 EST,closed,20160325 10:16:07 EST,28571.43,,,1.0,1.0,,BTCUSD,,20495600.0,-1.0,317869487.75,1479810.5,16622100.0,451902500.0
92.0,9041616.25,20160325 11:46:57 EST,20160325 11:46:57 EST,20160325 11:46:57 EST,29566.36,,BTCUSD,short,,20160325 10:31:02 EST,closed,20160325 10:31:02 EST,30620.99,,,1.0,1.0,,BTCUSD,,10546300.0,1.0,326911104.0,1504683.75,6075800.0,462448800.0
93.0,236783.5,20160325 12:02:06 EST,20160325 12:02:06 EST,20160325 12:02:06 EST,29738.3,,BTCUSD,long,,20160325 11:46:57 EST,closed,20160325 11:46:57 EST,29566.36,,,1.0,1.0,,BTCUSD,,1719400.0,-1.0,327147887.5,1482616.5,7795200.0,464168200.0
94.0,-7148333.25,20160325 12:31:47 EST,20160325 12:31:47 EST,20160325 12:31:47 EST,30303.03,,BTCUSD,short,,20160325 12:02:06 EST,closed,20160325 12:02:06 EST,29738.3,,,1.0,1.0,,BTCUSD,,-5647300.0,1.0,319999554.25,1501033.25,13442500.0,458520900.0
95.0,-5323307.25,20160325 13:01:30 EST,20160325 13:01:30 EST,20160325 13:01:30 EST,29921.26,,BTCUSD,long,,20160325 12:31:47 EST,closed,20160325 12:31:47 EST,30303.03,,,1.0,1.0,,BTCUSD,,-3817700.0,-1.0,314676247.0,1505607.25,9624800.0,454703200.0
96.0,-4863761.25,20160325 13:17:24 EST,20160325 13:17:24 EST,20160325 13:17:24 EST,30257.19,,BTCUSD,short,,20160325 13:01:30 EST,closed,20160325 13:01:30 EST,29921.26,,,1.0,1.0,,BTCUSD,,-3359300.0,1.0,309812485.75,1504461.25,12984100.0,451343900.0
97.0,-4078329.75,20160325 13:31:43 EST,20160325 13:31:43 EST,20160325 13:31:43 EST,30000.0,,BTCUSD,long,,20160325 13:17:24 EST,closed,20160325 13:17:24 EST,30257.19,,,1.0,1.0,,BTCUSD,,-2571900.0,-1.0,305734156.0,1506429.75,10412200.0,448772000.0
98.0,-1500000.0,20160325 13:46:01 EST,20160325 13:46:01 EST,20160325 13:46:01 EST,30000.0,,BTCUSD,short,,20160325 13:31:43 EST,closed,20160325 13:31:43 EST,30000.0,,,1.0,1.0,,BTCUSD,,0.0,1.0,304234156.0,1500000.0,10412200.0,448772000.0
99.0,2351946.0,20160325 14:16:39 EST,20160325 14:16:39 EST,20160325 14:16:39 EST,30386.16,,BTCUSD,long,,20160325 13:46:01 EST,closed,20160325 13:46:01 EST,30000.0,,,1.0,1.0,,BTCUSD,,3861600.0,-1.0,306586102.0,1509654.0,14273800.0,452633600.0
100.0,-1262367.25,20160325 14:47:46 EST,20160325 14:47:46 EST,20160325 14:47:46 EST,30360.53,,BTCUSD,short,,20160325 14:16:39 EST,closed,20160325 14:16:39 EST,30386.16,,,1.0,1.0,,BTCUSD,,256300.0,1.0,305323734.75,1518667.25,14017500.0,452889900.0
101.0,135728.75,20160325 15:02:25 EST,20160325 15:02:25 EST,20160325 15:02:25 EST,30526.32,,BTCUSD,long,,20160325 14:47:46 EST,closed,20160325 14:47:46 EST,30360.53,,,1.0,1.0,,BTCUSD,,1657900.0,-1.0,305459463.5,1522171.25,15675400.0,454547800.0
102.0,2747542.0,20160325 15:16:59 EST,20160325 15:16:59 EST,20160325 15:16:59 EST,30100.0,,BTCUSD,short,,20160325 15:02:25 EST,closed,20160325 15:02:25 EST,30526.32,,,1.0,1.0,,BTCUSD,,4263200.0,1.0,308207005.5,1515658.0,11412200.0,458811000.0
103.0,4041499.0,20160325 15:31:39 EST,20160325 15:31:39 EST,20160325 15:31:39 EST,30656.04,,BTCUSD,long,,20160325 15:16:59 EST,closed,20160325 15:16:59 EST,30100.0,,,1.0,1.0,,BTCUSD,,5560400.0,-1.0,312248504.5,1518901.0,16972600.0,464371400.0
104.0,4402699.75,20160325 15:46:29 EST,20160325 15:46:29 EST,20160325 15:46:29 EST,30063.97,,BTCUSD,short,,20160325 15:31:39 EST,closed,20160325 15:31:39 EST,30656.04,,,1.0,1.0,,BTCUSD,,5920700.0,1.0,316651204.25,1518000.25,11051900.0,470292100.0
105.0,5666731.75,20160325 16:46:31 EST,20160325 16:46:31 EST,20160325 16:46:31 EST,30782.76,,BTCUSD,long,,20160325 15:46:29 EST,closed,20160325 15:46:29 EST,30063.97,,,1.0,1.0,,BTCUSD,,7187900.0,-1.0,322317936.0,1521168.25,18239800.0,477480000.0
106.0,6908328.0,20160325 17:51:22 EST,20160325 17:51:22 EST,20160325 17:51:22 EST,29940.12,,BTCUSD,short,,20160325 16:46:31 EST,closed,20160325 16:46:31 EST,30782.76,,,1.0,1.0,,BTCUSD,,8426400.0,1.0,329226264.0,1518072.0,9813400.0,485906400.0
107.0,6105639.75,20160325 18:17:42 EST,20160325 18:17:42 EST,20160325 18:17:42 EST,30702.29,,BTCUSD,long,,20160325 17:51:22 EST,closed,20160325 17:51:22 EST,29940.12,,,1.0,1.0,,BTCUSD,,7621700.0,-1.0,335331903.75,1516060.25,17435100.0,493528100.0
108.0,6181529.0,20160325 18:32:56 EST,20160325 18:32:56 EST,20160325 18:32:56 EST,29932.55,,BTCUSD,short,,20160325 18:17:42 EST,closed,20160325 18:17:42 EST,30702.29,,,1.0,1.0,,BTCUSD,,7697400.0,1.0,341513432.75,1515871.0,9737700.0,501225500.0
109.0,11644936.25,20160325 19:47:29 EST,20160325 19:47:29 EST,20160325 19:47:29 EST,31250.0,,BTCUSD,long,,20160325 18:32:56 EST,closed,20160325 18:32:56 EST,29932.55,,,1.0,1.0,,BTCUSD,,13174500.0,-1.0,353158369.0,1529563.75,22912200.0,514400000.0
110.0,7930874.25,20160325 20:18:55 EST,20160325 20:18:55 EST,20160325 20:18:55 EST,30303.03,,BTCUSD,short,,20160325 19:47:29 EST,closed,20160325 19:47:29 EST,31250.0,,,1.0,1.0,,BTCUSD,,9469700.0,1.0,361089243.25,1538825.75,13442500.0,523869700.0
111.0,5248297.5,20160325 20:46:52 EST,20160325 20:46:52 EST,20160325 20:46:52 EST,30981.07,,BTCUSD,long,,20160325 20:18:55 EST,closed,20160325 20:18:55 EST,30303.03,,,1.0,1.0,,BTCUSD,,6780400.0,-1.0,366337540.75,1532102.5,20222900.0,530650100.0
112.0,-4245076.75,20160325 21:03:01 EST,20160325 21:03:01 EST,20160325 21:03:01 EST,31250.0,,BTCUSD,short,,20160325 20:46:52 EST,closed,20160325 20:46:52 EST,30981.07,,,1.0,1.0,,BTCUSD,,-2689300.0,1.0,362092464.0,1555776.75,22912200.0,527960800.0
113.0,-2855958.25,20160325 22:02:52 EST,20160325 22:02:52 EST,20160325 22:02:52 EST,31120.33,,BTCUSD,long,,20160325 21:03:01 EST,closed,20160325 21:03:01 EST,31250.0,,,1.0,1.0,,BTCUSD,,-1296700.0,-1.0,359236505.75,1559258.25,21615500.0,526664100.0
114.0,2708117.25,20160325 22:31:32 EST,20160325 22:31:32 EST,20160325 22:31:32 EST,30694.98,,BTCUSD,short,,20160325 22:02:52 EST,closed,20160325 22:02:52 EST,31120.33,,,1.0,1.0,,BTCUSD,,4253500.0,1.0,361944623.0,1545382.75,17362000.0,530917600.0
115.0,-1507916.25,20160325 22:48:26 EST,20160325 22:48:26 EST,20160325 22:48:26 EST,30697.67,,BTCUSD,long,,20160325 22:31:32 EST,closed,20160325 22:31:32 EST,30694.98,,,1.0,1.0,,BTCUSD,,26900.0,-1.0,360436706.75,1534816.25,17388900.0,530944500.0
116.0,7600598.25,20160325 23:17:19 EST,20160325 23:17:19 EST,20160325 23:17:19 EST,29786.4,,BTCUSD,short,,20160325 22:48:26 EST,closed,20160325 22:48:26 EST,30697.67,,,1.0,1.0,,BTCUSD,,9112700.0,1.0,368037305.0,1512101.75,8276200.0,540057200.0
117.0,11924062.5,20160325 23:46:41 EST,20160325 23:46:41 EST,20160325 23:46:41 EST,31131.1,,BTCUSD,long,,20160325 23:17:19 EST,closed,20160325 23:17:19 EST,29786.4,,,1.0,1.0,,BTCUSD,,13447000.0,-1.0,379961367.5,1522937.5,21723200.0,553504200.0
118.0,2840510.25,20160326 00:33:34 EST,20160326 00:33:34 EST,20160326 00:33:34 EST,30692.49,,BTCUSD,short,,20160325 23:46:41 EST,closed,20160325 23:46:41 EST,31131.1,,,1.0,1.0,,BTCUSD,,4386100.0,1.0,382801877.75,1545589.75,17337100.0,557890300.0
119.0,2475724.5,20160326 01:03:54 EST,20160326 01:03:54 EST,20160326 01:03:54 EST,31094.53,,BTCUSD,long,,20160326 00:33:34 EST,closed,20160326 00:33:34 EST,30692.49,,,1.0,1.0,,BTCUSD,,4020400.0,-1.0,385277602.25,1544675.5,21357500.0,561910700.0
120.0,-1813371.5,20160326 01:17:30 EST,20160326 01:17:30 EST,20160326 01:17:30 EST,31120.33,,BTCUSD,short,,20160326 01:03:54 EST,closed,20160326 01:03:54 EST,31094.53,,,1.0,1.0,,BTCUSD,,-258000.0,1.0,383464230.75,1555371.5,21615500.0,561652700.0
121.0,-1414072.25,20160326 01:31:35 EST,20160326 01:31:35 EST,20160326 01:31:35 EST,31134.56,,BTCUSD,long,,20160326 01:17:30 EST,closed,20160326 01:17:30 EST,31120.33,,,1.0,1.0,,BTCUSD,,142300.0,-1.0,382050158.5,1556372.25,21757800.0,561795000.0
122.0,-3118222.0,20160326 02:19:49 EST,20160326 02:19:49 EST,20160326 02:19:49 EST,31290.32,,BTCUSD,short,,20160326 01:31:35 EST,closed,20160326 01:31:35 EST,31134.56,,,1.0,1.0,,BTCUSD,,-1557600.0,1.0,378931936.5,1560622.0,23315400.0,560237400.0
123.0,-9278582.5,20160326 02:33:53 EST,20160326 02:33:53 EST,20160326 02:33:53 EST,30516.98,,BTCUSD,long,,20160326 02:19:49 EST,closed,20160326 02:19:49 EST,31290.32,,,1.0,1.0,,BTCUSD,,-7733400.0,-1.0,369653354.0,1545182.5,15582000.0,552504000.0
124.0,2449063.5,20160326 02:48:57 EST,20160326 02:48:57 EST,20160326 02:48:57 EST,30120.48,,BTCUSD,short,,20160326 02:33:53 EST,closed,20160326 02:33:53 EST,30516.98,,,1.0,1.0,,BTCUSD,,3965000.0,1.0,372102417.5,1515936.5,11617000.0,556469000.0
125.0,-342240.75,20160326 03:51:20 EST,20160326 03:51:20 EST,20160326 03:51:20 EST,30237.15,,BTCUSD,long,,20160326 02:48:57 EST,closed,20160326 02:48:57 EST,30120.48,,,1.0,1.0,,BTCUSD,,1166700.0,-1.0,371760176.75,1508940.75,12783700.0,557635700.0
126.0,-4024623.75,20160326 04:02:17 EST,20160326 04:02:17 EST,20160326 04:02:17 EST,30487.8,,BTCUSD,short,,20160326 03:51:20 EST,closed,20160326 03:51:20 EST,30237.15,,,1.0,1.0,,BTCUSD,,-2506500.0,1.0,367735553.0,1518123.75,15290200.0,555129200.0
127.0,2922764.25,20160326 04:20:43 EST,20160326 04:20:43 EST,20160326 04:20:43 EST,30933.63,,BTCUSD,long,,20160326 04:02:17 EST,closed,20160326 04:02:17 EST,30487.8,,,1.0,1.0,,BTCUSD,,4458300.0,-1.0,370658317.25,1535535.75,19748500.0,559587500.0
128.0,3454289.75,20160326 05:02:07 EST,20160326 05:02:07 EST,20160326 05:02:07 EST,30434.78,,BTCUSD,short,,20160326 04:20:43 EST,closed,20160326 04:20:43 EST,30933.63,,,1.0,1.0,,BTCUSD,,4988500.0,1.0,374112607.0,1534210.25,14760000.0,564576000.0
129.0,-1609718.5,20160326 05:19:32 EST,20160326 05:19:32 EST,20160326 05:19:32 EST,30425.96,,BTCUSD,long,,20160326 05:02:07 EST,closed,20160326 05:02:07 EST,30434.78,,,1.0,1.0,,BTCUSD,,-88200.0,-1.0,372502888.5,1521518.5,14671800.0,564487800.0
130.0,-2607907.75,20160326 05:37:15 EST,20160326 05:37:15 EST,20160326 05:37:15 EST,30534.35,,BTCUSD,short,,20160326 05:19:32 EST,closed,20160326 05:19:32 EST,30425.96,,,1.0,1.0,,BTCUSD,,-1083900.0,1.0,369894980.75,1524007.75,15755700.0,563403900.0
131.0,-2495888.5,20160326 06:06:58 EST,20160326 06:06:58 EST,20160326 06:06:58 EST,30437.19,,BTCUSD,long,,20160326 05:37:15 EST,closed,20160326 05:37:15 EST,30534.35,,,1.0,1.0,,BTCUSD,,-971600.0,-1.0,367399092.25,1524288.5,14784100.0,562432300.0
132.0,-1497699.25,20160326 06:20:21 EST,20160326 06:20:21 EST,20160326 06:20:21 EST,30434.78,,BTCUSD,short,,20160326 06:06:58 EST,closed,20160326 06:06:58 EST,30437.19,,,1.0,1.0,,BTCUSD,,24100.0,1.0,365901393.0,1521799.25,14760000.0,562456400.0
133.0,-1521739.0,20160326 06:33:43 EST,20160326 06:33:43 EST,20160326 06:33:43 EST,30434.78,,BTCUSD,long,,20160326 06:20:21 EST,closed,20160326 06:20:21 EST,30434.78,,,1.0,1.0,,BTCUSD,,0.0,-1.0,364379654.0,1521739.0,14760000.0,562456400.0
134.0,-1124348.0,20160326 06:49:32 EST,20160326 06:49:32 EST,20160326 06:49:32 EST,30395.14,,BTCUSD,short,,20160326 06:33:43 EST,closed,20160326 06:33:43 EST,30434.78,,,1.0,1.0,,BTCUSD,,396400.0,1.0,363255306.0,1520748.0,14363600.0,562852800.0
135.0,-4094803.25,20160326 07:01:58 EST,20160326 07:01:58 EST,20160326 07:01:58 EST,30136.99,,BTCUSD,long,,20160326 06:49:32 EST,closed,20160326 06:49:32 EST,30395.14,,,1.0,1.0,,BTCUSD,,-2581500.0,-1.0,359160502.75,1513303.25,11782100.0,560271300.0
136.0,-3171400.5,20160326 07:17:47 EST,20160326 07:17:47 EST,20160326 07:17:47 EST,30303.03,,BTCUSD,short,,20160326 07:01:58 EST,closed,20160326 07:01:58 EST,30136.99,,,1.0,1.0,,BTCUSD,,-1660400.0,1.0,355989102.25,1511000.5,13442500.0,558610900.0
137.0,-4537875.75,20160326 07:46:14 EST,20160326 07:46:14 EST,20160326 07:46:14 EST,30000.0,,BTCUSD,long,,20160326 07:17:47 EST,closed,20160326 07:17:47 EST,30303.03,,,1.0,1.0,,BTCUSD,,-3030300.0,-1.0,351451226.5,1507575.75,10412200.0,555580600.0
138.0,1016275.0,20160326 08:17:07 EST,20160326 08:17:07 EST,20160326 08:17:07 EST,29749.0,,BTCUSD,short,,20160326 07:46:14 EST,closed,20160326 07:46:14 EST,30000.0,,,1.0,1.0,,BTCUSD,,2510000.0,1.0,352467501.5,1493725.0,7902200.0,558090600.0
139.0,4038999.25,20160326 09:05:05 EST,20160326 09:05:05 EST,20160326 09:05:05 EST,30303.03,,BTCUSD,long,,20160326 08:17:07 EST,closed,20160326 08:17:07 EST,29749.0,,,1.0,1.0,,BTCUSD,,5540300.0,-1.0,356506500.75,1501300.75,13442500.0,563630900.0
140.0,1522724.25,20160326 09:23:06 EST,20160326 09:23:06 EST,20160326 09:23:06 EST,30000.0,,BTCUSD,short,,20160326 09:05:05 EST,closed,20160326 09:05:05 EST,30303.03,,,1.0,1.0,,BTCUSD,,3030300.0,1.0,358029225.0,1507575.75,10412200.0,566661200.0
141.0,5372775.0,20160326 09:32:12 EST,20160326 09:32:12 EST,20160326 09:32:12 EST,30689.0,,BTCUSD,long,,20160326 09:23:06 EST,closed,20160326 09:23:06 EST,30000.0,,,1.0,1.0,,BTCUSD,,6890000.0,-1.0,363402000.0,1517225.0,17302200.0,573551200.0
142.0,1014105.5,20160326 10:03:57 EST,20160326 10:03:57 EST,20160326 10:03:57 EST,30434.78,,BTCUSD,short,,20160326 09:32:12 EST,closed,20160326 09:32:12 EST,30689.0,,,1.0,1.0,,BTCUSD,,2542200.0,1.0,364416105.5,1528094.5,14760000.0,576093400.0
143.0,768720.5,20160326 10:31:53 EST,20160326 10:31:53 EST,20160326 10:31:53 EST,30664.4,,BTCUSD,long,,20160326 10:03:57 EST,closed,20160326 10:03:57 EST,30434.78,,,1.0,1.0,,BTCUSD,,2296200.0,-1.0,365184826.0,1527479.5,17056200.0,578389600.0
144.0,-1555976.75,20160326 10:49:37 EST,20160326 10:49:37 EST,20160326 10:49:37 EST,30666.67,,BTCUSD,short,,20160326 10:31:53 EST,closed,20160326 10:31:53 EST,30664.4,,,1.0,1.0,,BTCUSD,,-22700.0,1.0,363628849.25,1533276.75,17078900.0,578366900.0
145.0,-3162949.25,20160326 11:19:10 EST,20160326 11:19:10 EST,20160326 11:19:10 EST,30503.3,,BTCUSD,long,,20160326 10:49:37 EST,closed,20160326 10:49:37 EST,30666.67,,,1.0,1.0,,BTCUSD,,-1633700.0,-1.0,360465900.0,1529249.25,15445200.0,576733200.0
146.0,2766637.75,20160326 12:20:55 EST,20160326 12:20:55 EST,20160326 12:20:55 EST,30075.19,,BTCUSD,short,,20160326 11:19:10 EST,closed,20160326 11:19:10 EST,30503.3,,,1.0,1.0,,BTCUSD,,4281100.0,1.0,363232537.75,1514462.25,11164100.0,581014300.0
147.0,3742093.0,20160326 12:40:00 EST,20160326 12:40:00 EST,20160326 12:40:00 EST,30601.09,,BTCUSD,long,,20160326 12:20:55 EST,closed,20160326 12:20:55 EST,30075.19,,,1.0,1.0,,BTCUSD,,5259000.0,-1.0,366974630.75,1516907.0,16423100.0,586273300.0
148.0,-9609703.25,20160326 13:19:26 EST,20160326 13:19:26 EST,20160326 13:19:26 EST,31407.04,,BTCUSD,short,,20160326 12:40:00 EST,closed,20160326 12:40:00 EST,30601.09,,,1.0,1.0,,BTCUSD,,-8059500.0,1.0,357364927.5,1550203.25,24482600.0,578213800.0
149.0,-13860350.0,20160326 13:34:25 EST,20160326 13:34:25 EST,20160326 13:34:25 EST,30174.96,,BTCUSD,long,,20160326 13:19:26 EST,closed,20160326 13:19:26 EST,31407.04,,,1.0,1.0,,BTCUSD,,-12320800.0,-1.0,343504577.5,1539550.0,12161800.0,565893000.0
150.0,-14677487.75,20160326 13:39:27 EST,20160326 13:39:27 EST,20160326 13:39:27 EST,31488.55,,BTCUSD,short,,20160326 13:34:25 EST,closed,20160326 13:34:25 EST,30174.96,,,1.0,1.0,,BTCUSD,,-13135900.0,1.0,328827089.75,1541587.75,25297700.0,552757100.0
151.0,-6185870.0,20160326 14:20:41 EST,20160326 14:20:41 EST,20160326 14:20:41 EST,31026.25,,BTCUSD,long,,20160326 13:39:27 EST,closed,20160326 13:39:27 EST,31488.55,,,1.0,1.0,,BTCUSD,,-4623000.0,-1.0,322641219.75,1562870.0,20674700.0,548134100.0
152.0,9935031.75,20160326 14:46:29 EST,20160326 14:46:29 EST,20160326 14:46:29 EST,29880.48,,BTCUSD,short,,20160326 14:20:41 EST,closed,20160326 14:20:41 EST,31026.25,,,1.0,1.0,,BTCUSD,,11457700.0,1.0,332576251.5,1522668.25,9217000.0,559591800.0
153.0,2990536.5,20160326 15:17:25 EST,20160326 15:17:25 EST,20160326 15:17:25 EST,30330.06,,BTCUSD,long,,20160326 14:46:29 EST,closed,20160326 14:46:29 EST,29880.48,,,1.0,1.0,,BTCUSD,,4495800.0,-1.0,335566788.0,1505263.5,13712800.0,564087600.0
154.0,2841264.25,20160326 15:53:34 EST,20160326 15:53:34 EST,20160326 15:53:34 EST,29895.37,,BTCUSD,short,,20160326 15:17:25 EST,closed,20160326 15:17:25 EST,30330.06,,,1.0,1.0,,BTCUSD,,4346900.0,1.0,338408052.25,1505635.75,9365900.0,568434500.0
155.0,17685261.25,20160326 16:30:59 EST,20160326 16:30:59 EST,20160326 16:30:59 EST,31818.18,,BTCUSD,long,,20160326 15:53:34 EST,closed,20160326 15:53:34 EST,29895.37,,,1.0,1.0,,BTCUSD,,19228100.0,-1.0,356093313.5,1542838.75,28594000.0,587662600.0
156.0,10750367.25,20160326 16:51:46 EST,20160326 16:51:46 EST,20160326 16:51:46 EST,30587.13,,BTCUSD,short,,20160326 16:30:59 EST,closed,20160326 16:30:59 EST,31818.18,,,1.0,1.0,,BTCUSD,,12310500.0,1.0,366843680.75,1560132.75,16283500.0,599973100.0
157.0,6216330.75,20160326 17:23:42 EST,20160326 17:23:42 EST,20160326 17:23:42 EST,31363.64,,BTCUSD,long,,20160326 16:51:46 EST,closed,20160326 16:51:46 EST,30587.13,,,1.0,1.0,,BTCUSD,,7765100.0,-1.0,373060011.5,1548769.25,24048600.0,607738200.0
158.0,-7066894.5,20160326 17:51:04 EST,20160326 17:51:04 EST,20160326 17:51:04 EST,31912.14,,BTCUSD,short,,20160326 17:23:42 EST,closed,20160326 17:23:42 EST,31363.64,,,1.0,1.0,,BTCUSD,,-5485000.0,1.0,365993117.0,1581894.5,29533600.0,602253200.0
159.0,-16625238.75,20160326 18:02:02 EST,20160326 18:02:02 EST,20160326 18:02:02 EST,30405.41,,BTCUSD,long,,20160326 17:51:04 EST,closed,20160326 17:51:04 EST,31912.14,,,1.0,1.0,,BTCUSD,,-15067300.0,-1.0,349367878.25,1557938.75,14466300.0,587185900.0
160.0,-17583829.25,20160326 18:51:31 EST,20160326 18:51:31 EST,20160326 18:51:31 EST,32007.76,,BTCUSD,short,,20160326 18:02:02 EST,closed,20160326 18:02:02 EST,30405.41,,,1.0,1.0,,BTCUSD,,-16023500.0,1.0,331784049.0,1560329.25,30489800.0,571162400.0
161.0,-11095191.5,20160326 19:02:56 EST,20160326 19:02:56 EST,20160326 19:02:56 EST,31055.9,,BTCUSD,long,,20160326 18:51:31 EST,closed,20160326 18:51:31 EST,32007.76,,,1.0,1.0,,BTCUSD,,-9518600.0,-1.0,320688857.5,1576591.5,20971200.0,561643800.0
162.0,6927352.5,20160326 19:47:29 EST,20160326 19:47:29 EST,20160326 19:47:29 EST,30210.0,,BTCUSD,short,,20160326 19:02:56 EST,closed,20160326 19:02:56 EST,31055.9,,,1.0,1.0,,BTCUSD,,8459000.0,1.0,327616210.0,1531647.5,12512200.0,570102800.0
163.0,-1510500.0,20160326 20:04:00 EST,20160326 20:04:00 EST,20160326 20:04:00 EST,30210.0,,BTCUSD,long,,20160326 19:47:29 EST,closed,20160326 19:47:29 EST,30210.0,,,1.0,1.0,,BTCUSD,,0.0,-1.0,326105710.0,1510500.0,12512200.0,570102800.0
164.0,-12062113.25,20160326 20:20:33 EST,20160326 20:20:33 EST,20160326 20:20:33 EST,31262.53,,BTCUSD,short,,20160326 20:04:00 EST,closed,20160326 20:04:00 EST,30210.0,,,1.0,1.0,,BTCUSD,,-10525300.0,1.0,314043596.75,1536813.25,23037500.0,559577500.0
165.0,-11134139.0,20160326 20:31:38 EST,20160326 20:31:38 EST,20160326 20:31:38 EST,30303.03,,BTCUSD,long,,20160326 20:20:33 EST,closed,20160326 20:20:33 EST,31262.53,,,1.0,1.0,,BTCUSD,,-9595000.0,-1.0,302909457.75,1539139.0,13442500.0,549982500.0
166.0,-573904.25,20160326 20:53:59 EST,20160326 20:53:59 EST,20160326 20:53:59 EST,30209.14,,BTCUSD,short,,20160326 20:31:38 EST,closed,20160326 20:31:38 EST,30303.03,,,1.0,1.0,,BTCUSD,,938900.0,1.0,302335553.5,1512804.25,12503600.0,550921400.0
167.0,-7145035.25,20160326 21:49:16 EST,20160326 21:49:16 EST,20160326 21:49:16 EST,29644.27,,BTCUSD,long,,20160326 20:53:59 EST,closed,20160326 20:53:59 EST,30209.14,,,1.0,1.0,,BTCUSD,,-5648700.0,-1.0,295190518.25,1496335.25,6854900.0,545272700.0
168.0,2971593.25,20160326 22:02:55 EST,20160326 22:02:55 EST,20160326 22:02:55 EST,29200.0,,BTCUSD,short,,20160326 21:49:16 EST,closed,20160326 21:49:16 EST,29644.27,,,1.0,1.0,,BTCUSD,,4442700.0,1.0,298162111.5,1471106.75,2412200.0,549715400.0
169.0,9013750.0,20160326 22:32:52 EST,20160326 22:32:52 EST,20160326 22:32:52 EST,30250.0,,BTCUSD,long,,20160326 22:02:55 EST,closed,20160326 22:02:55 EST,29200.0,,,1.0,1.0,,BTCUSD,,10500000.0,-1.0,307175861.5,1486250.0,12912200.0,560215400.0
170.0,-10476955.25,20160326 22:46:17 EST,20160326 22:46:17 EST,20160326 22:46:17 EST,31144.21,,BTCUSD,short,,20160326 22:32:52 EST,closed,20160326 22:32:52 EST,30250.0,,,1.0,1.0,,BTCUSD,,-8942100.0,1.0,296698906.25,1534855.25,21854300.0,551273300.0
171.0,-585047.0,20160326 23:03:56 EST,20160326 23:03:56 EST,20160326 23:03:56 EST,31241.67,,BTCUSD,long,,20160326 22:46:17 EST,closed,20160326 22:46:17 EST,31144.21,,,1.0,1.0,,BTCUSD,,974600.0,-1.0,296113859.25,1559647.0,22828900.0,552247900.0
172.0,10885658.25,20160326 23:22:03 EST,20160326 23:22:03 EST,20160326 23:22:03 EST,30000.0,,BTCUSD,short,,20160326 23:03:56 EST,closed,20160326 23:03:56 EST,31241.67,,,1.0,1.0,,BTCUSD,,12416700.0,1.0,306999517.5,1531041.75,10412200.0,564664600.0
173.0,10385412.0,20160326 23:34:02 EST,20160326 23:34:02 EST,20160326 23:34:02 EST,31191.52,,BTCUSD,long,,20160326 23:22:03 EST,closed,20160326 23:22:03 EST,30000.0,,,1.0,1.0,,BTCUSD,,11915200.0,-1.0,317384929.5,1529788.0,22327400.0,576579800.0
174.0,7347536.25,20160326 23:50:49 EST,20160326 23:50:49 EST,20160326 23:50:49 EST,30303.03,,BTCUSD,short,,20160326 23:34:02 EST,closed,20160326 23:34:02 EST,31191.52,,,1.0,1.0,,BTCUSD,,8884900.0,1.0,324732465.75,1537363.75,13442500.0,585464700.0
175.0,-1369716.0,20160327 00:19:07 EST,20160327 00:19:07 EST,20160327 00:19:07 EST,30317.61,,BTCUSD,long,,20160326 23:50:49 EST,closed,20160326 23:50:49 EST,30303.03,,,1.0,1.0,,BTCUSD,,145800.0,-1.0,323362749.75,1515516.0,13588300.0,585610500.0
176.0,8429922.0,20160327 00:47:33 EST,20160327 00:47:33 EST,20160327 00:47:33 EST,29325.51,,BTCUSD,short,,20160327 00:19:07 EST,closed,20160327 00:19:07 EST,30317.61,,,1.0,1.0,,BTCUSD,,9921000.0,1.0,331792671.75,1491078.0,3667300.0,595531500.0
177.0,6291481.5,20160327 01:05:13 EST,20160327 01:05:13 EST,20160327 01:05:13 EST,30103.23,,BTCUSD,long,,20160327 00:47:33 EST,closed,20160327 00:47:33 EST,29325.51,,,1.0,1.0,,BTCUSD,,7777200.0,-1.0,338084153.25,1485718.5,11444500.0,603308700.0
178.0,-2205808.75,20160327 01:34:19 EST,20160327 01:34:19 EST,20160327 01:34:19 EST,30173.12,,BTCUSD,short,,20160327 01:05:13 EST,closed,20160327 01:05:13 EST,30103.23,,,1.0,1.0,,BTCUSD,,-698900.0,1.0,335878344.5,1506908.75,12143400.0,602609800.0
179.0,5384867.0,20160327 01:51:30 EST,20160327 01:51:30 EST,20160327 01:51:30 EST,30864.2,,BTCUSD,long,,20160327 01:34:19 EST,closed,20160327 01:34:19 EST,30173.12,,,1.0,1.0,,BTCUSD,,6910800.0,-1.0,341263211.5,1525933.0,19054200.0,609520600.0
180.0,3713799.75,20160327 02:49:34 EST,20160327 02:49:34 EST,20160327 02:49:34 EST,30339.81,,BTCUSD,short,,20160327 01:51:30 EST,closed,20160327 01:51:30 EST,30864.2,,,1.0,1.0,,BTCUSD,,5243900.0,1.0,344977011.25,1530100.25,13810300.0,614764500.0
181.0,3985518.75,20160327 03:02:02 EST,20160327 03:02:02 EST,20160327 03:02:02 EST,30891.44,,BTCUSD,long,,20160327 02:49:34 EST,closed,20160327 02:49:34 EST,30339.81,,,1.0,1.0,,BTCUSD,,5516300.0,-1.0,348962530.0,1530781.25,19326600.0,620280800.0
182.0,4354238.25,20160327 03:20:06 EST,20160327 03:20:06 EST,20160327 03:20:06 EST,30303.03,,BTCUSD,short,,20160327 03:02:02 EST,closed,20160327 03:02:02 EST,30891.44,,,1.0,1.0,,BTCUSD,,5884100.0,1.0,353316768.25,1529861.75,13442500.0,626164900.0
183.0,2049414.75,20160327 04:07:11 EST,20160327 04:07:11 EST,20160327 04:07:11 EST,30660.38,,BTCUSD,long,,20160327 03:20:06 EST,closed,20160327 03:20:06 EST,30303.03,,,1.0,1.0,,BTCUSD,,3573500.0,-1.0,355366183.0,1524085.25,17016000.0,629738400.0
184.0,-871669.75,20160327 04:18:05 EST,20160327 04:18:05 EST,20160327 04:18:05 EST,30594.41,,BTCUSD,short,,20160327 04:07:11 EST,closed,20160327 04:07:11 EST,30660.38,,,1.0,1.0,,BTCUSD,,659700.0,1.0,354494513.25,1531369.75,16356300.0,630398100.0
185.0,-3386267.5,20160327 04:34:29 EST,20160327 04:34:29 EST,20160327 04:34:29 EST,30408.29,,BTCUSD,long,,20160327 04:18:05 EST,closed,20160327 04:18:05 EST,30594.41,,,1.0,1.0,,BTCUSD,,-1861200.0,-1.0,351108245.75,1525067.5,14495100.0,628536900.0
186.0,19813988.5,20160327 06:03:46 EST,20160327 06:03:46 EST,20160327 06:03:46 EST,28280.17,,BTCUSD,short,,20160327 04:34:29 EST,closed,20160327 04:34:29 EST,30408.29,,,1.0,1.0,,BTCUSD,,21281200.0,1.0,370922234.25,1467211.5,-6786100.0,649818100.0
187.0,21848389.75,20160327 06:33:42 EST,20160327 06:33:42 EST,20160327 06:33:42 EST,30612.24,,BTCUSD,long,,20160327 06:03:46 EST,closed,20160327 06:03:46 EST,28280.17,,,1.0,1.0,,BTCUSD,,23320700.0,-1.0,392770624.0,1472310.25,16534600.0,673138800.0
188.0,11353016.75,20160327 07:20:29 EST,20160327 07:20:29 EST,20160327 07:20:29 EST,29327.09,,BTCUSD,short,,20160327 06:33:42 EST,closed,20160327 06:33:42 EST,30612.24,,,1.0,1.0,,BTCUSD,,12851500.0,1.0,404123640.75,1498483.25,3683100.0,685990300.0
189.0,19495908.5,20160327 10:01:12 EST,20160327 10:01:12 EST,20160327 10:01:12 EST,31428.57,,BTCUSD,long,,20160327 07:20:29 EST,closed,20160327 07:20:29 EST,29327.09,,,1.0,1.0,,BTCUSD,,21014800.0,-1.0,423619549.25,1518891.5,24697900.0,707005100.0
190.0,14246217.0,20160327 10:30:58 EST,20160327 10:30:58 EST,20160327 10:30:58 EST,29850.75,,BTCUSD,short,,20160327 10:01:12 EST,closed,20160327 10:01:12 EST,31428.57,,,1.0,1.0,,BTCUSD,,15778200.0,1.0,437865766.25,1531983.0,8919700.0,722783300.0
191.0,-14579139.0,20160327 11:16:33 EST,20160327 11:16:33 EST,20160327 11:16:33 EST,28538.81,,BTCUSD,long,,20160327 10:30:58 EST,closed,20160327 10:30:58 EST,29850.75,,,1.0,1.0,,BTCUSD,,-13119400.0,-1.0,423286627.25,1459739.0,-4199700.0,709663900.0
192.0,-14706757.25,20160327 12:02:34 EST,20160327 12:02:34 EST,20160327 12:02:34 EST,29863.48,,BTCUSD,short,,20160327 11:16:33 EST,closed,20160327 11:16:33 EST,28538.81,,,1.0,1.0,,BTCUSD,,-13246700.0,1.0,408579870.0,1460057.25,9047000.0,696417200.0
193.0,5975707.0,20160327 12:33:20 EST,20160327 12:33:20 EST,20160327 12:33:20 EST,30612.24,,BTCUSD,long,,20160327 12:02:34 EST,closed,20160327 12:02:34 EST,29863.48,,,1.0,1.0,,BTCUSD,,7487600.0,-1.0,414555577.0,1511893.0,16534600.0,703904800.0
194.0,-4694502.0,20160327 12:48:27 EST,20160327 12:48:27 EST,20160327 12:48:27 EST,30927.84,,BTCUSD,short,,20160327 12:33:20 EST,closed,20160327 12:33:20 EST,30612.24,,,1.0,1.0,,BTCUSD,,-3156000.0,1.0,409861075.0,1538502.0,19690600.0,700748800.0
195.0,-18229779.0,20160327 13:48:28 EST,20160327 13:48:28 EST,20160327 13:48:28 EST,29255.32,,BTCUSD,long,,20160327 12:48:27 EST,closed,20160327 12:48:27 EST,30927.84,,,1.0,1.0,,BTCUSD,,-16725200.0,-1.0,391631296.0,1504579.0,2965400.0,684023600.0
196.0,-6591556.0,20160327 14:02:47 EST,20160327 14:02:47 EST,20160327 14:02:47 EST,29766.92,,BTCUSD,short,,20160327 13:48:28 EST,closed,20160327 13:48:28 EST,29255.32,,,1.0,1.0,,BTCUSD,,-5116000.0,1.0,385039740.0,1475556.0,8081400.0,678907600.0
197.0,11851022.0,20160327 14:18:56 EST,20160327 14:18:56 EST,20160327 14:18:56 EST,31104.2,,BTCUSD,long,,20160327 14:02:47 EST,closed,20160327 14:02:47 EST,29766.92,,,1.0,1.0,,BTCUSD,,13372800.0,-1.0,396890762.0,1521778.0,21454200.0,692280400.0
198.0,-3846323.5,20160327 15:01:29 EST,20160327 15:01:29 EST,20160327 15:01:29 EST,31332.74,,BTCUSD,short,,20160327 14:18:56 EST,closed,20160327 14:18:56 EST,31104.2,,,1.0,1.0,,BTCUSD,,-2285400.0,1.0,393044438.5,1560923.5,23739600.0,689995000.0
199.0,-1741199.5,20160327 15:32:49 EST,20160327 15:32:49 EST,20160327 15:32:49 EST,31315.24,,BTCUSD,long,,20160327 15:01:29 EST,closed,20160327 15:01:29 EST,31332.74,,,1.0,1.0,,BTCUSD,,-175000.0,-1.0,391303239.0,1566199.5,23564600.0,689820000.0
200.0,3870194.0,20160327 16:04:24 EST,20160327 16:04:24 EST,20160327 16:04:24 EST,30773.0,,BTCUSD,short,,20160327 15:32:49 EST,closed,20160327 15:32:49 EST,31315.24,,,1.0,1.0,,BTCUSD,,5422400.0,1.0,395173433.0,1552206.0,18142200.0,695242400.0
201.0,-19368862.75,20160327 16:16:55 EST,20160327 16:16:55 EST,20160327 16:16:55 EST,28985.51,,BTCUSD,long,,20160327 16:04:24 EST,closed,20160327 16:04:24 EST,30773.0,,,1.0,1.0,,BTCUSD,,-17874900.0,-1.0,375804570.25,1493962.75,267300.0,677367500.0
202.0,-29198876.5,20160327 17:51:16 EST,20160327 17:51:16 EST,20160327 17:51:16 EST,31753.55,,BTCUSD,short,,20160327 16:16:55 EST,closed,20160327 16:16:55 EST,28985.51,,,1.0,1.0,,BTCUSD,,-27680400.0,1.0,346605693.75,1518476.5,27947700.0,649687100.0
203.0,-11076496.0,20160327 18:01:01 EST,20160327 18:01:01 EST,20160327 18:01:01 EST,30802.29,,BTCUSD,long,,20160327 17:51:16 EST,closed,20160327 17:51:16 EST,31753.55,,,1.0,1.0,,BTCUSD,,-9512600.0,-1.0,335529197.75,1563896.0,18435100.0,640174500.0
204.0,18411941.25,20160327 18:16:34 EST,20160327 18:16:34 EST,20160327 18:16:34 EST,28812.06,,BTCUSD,short,,20160327 18:01:01 EST,closed,20160327 18:01:01 EST,30802.29,,,1.0,1.0,,BTCUSD,,19902300.0,1.0,353941139.0,1490358.75,-1467200.0,660076800.0
205.0,15106425.75,20160327 19:01:22 EST,20160327 19:01:22 EST,20160327 19:01:22 EST,30470.91,,BTCUSD,long,,20160327 18:16:34 EST,closed,20160327 18:16:34 EST,28812.06,,,1.0,1.0,,BTCUSD,,16588500.0,-1.0,369047564.75,1482074.25,15121300.0,676665300.0
206.0,-609666.5,20160327 19:16:19 EST,20160327 19:16:19 EST,20160327 19:16:19 EST,30379.75,,BTCUSD,short,,20160327 19:01:22 EST,closed,20160327 19:01:22 EST,30470.91,,,1.0,1.0,,BTCUSD,,911600.0,1.0,368437898.25,1521266.5,14209700.0,677576900.0
207.0,627133.75,20160327 19:31:03 EST,20160327 19:31:03 EST,20160327 19:31:03 EST,30594.9,,BTCUSD,long,,20160327 19:16:19 EST,closed,20160327 19:16:19 EST,30379.75,,,1.0,1.0,,BTCUSD,,2151500.0,-1.0,369065032.0,1524366.25,16361200.0,679728400.0
208.0,2452586.0,20160327 20:18:26 EST,20160327 20:18:26 EST,20160327 20:18:26 EST,30197.66,,BTCUSD,short,,20160327 19:31:03 EST,closed,20160327 19:31:03 EST,30594.9,,,1.0,1.0,,BTCUSD,,3972400.0,1.0,371517618.0,1519814.0,12388800.0,683700800.0
209.0,7226122.25,20160327 20:47:05 EST,20160327 20:47:05 EST,20160327 20:47:05 EST,31073.45,,BTCUSD,long,,20160327 20:18:26 EST,closed,20160327 20:18:26 EST,30197.66,,,1.0,1.0,,BTCUSD,,8757900.0,-1.0,378743740.25,1531777.75,21146700.0,692458700.0
210.0,6343421.0,20160327 21:02:05 EST,20160327 21:02:05 EST,20160327 21:02:05 EST,30285.71,,BTCUSD,short,,20160327 20:47:05 EST,closed,20160327 20:47:05 EST,31073.45,,,1.0,1.0,,BTCUSD,,7877400.0,1.0,385087161.25,1533979.0,13269300.0,700336100.0
211.0,5291856.5,20160327 22:01:34 EST,20160327 22:01:34 EST,20160327 22:01:34 EST,30968.03,,BTCUSD,long,,20160327 21:02:05 EST,closed,20160327 21:02:05 EST,30285.71,,,1.0,1.0,,BTCUSD,,6823200.0,-1.0,390379017.75,1531343.5,20092500.0,707159300.0
212.0,4657274.0,20160327 22:16:11 EST,20160327 22:16:11 EST,20160327 22:16:11 EST,30349.01,,BTCUSD,short,,20160327 22:01:34 EST,closed,20160327 22:01:34 EST,30968.03,,,1.0,1.0,,BTCUSD,,6190200.0,1.0,395036291.75,1532926.0,13902300.0,713349500.0
213.0,4574681.0,20160327 22:46:59 EST,20160327 22:46:59 EST,20160327 22:46:59 EST,30959.75,,BTCUSD,long,,20160327 22:16:11 EST,closed,20160327 22:16:11 EST,30349.01,,,1.0,1.0,,BTCUSD,,6107400.0,-1.0,399610972.75,1532719.0,20009700.0,719456900.0
214.0,19918645.25,20160327 23:16:16 EST,20160327 23:16:16 EST,20160327 23:16:16 EST,28818.44,,BTCUSD,short,,20160327 22:46:59 EST,closed,20160327 22:46:59 EST,30959.75,,,1.0,1.0,,BTCUSD,,21413100.0,1.0,419529618.0,1494454.75,-1403400.0,740870000.0
215.0,25150632.5,20160328 01:02:20 EST,20160328 01:02:20 EST,20160328 01:02:20 EST,31484.26,,BTCUSD,long,,20160327 23:16:16 EST,closed,20160327 23:16:16 EST,28818.44,,,1.0,1.0,,BTCUSD,,26658200.0,-1.0,444680250.5,1507567.5,25254800.0,767528200.0
216.0,10803654.5,20160328 01:16:06 EST,20160328 01:16:06 EST,20160328 01:16:06 EST,30249.56,,BTCUSD,short,,20160328 01:02:20 EST,closed,20160328 01:02:20 EST,31484.26,,,1.0,1.0,,BTCUSD,,12347000.0,1.0,455483905.0,1543345.5,12907800.0,779875200.0
217.0,10248146.75,20160328 01:31:27 EST,20160328 01:31:27 EST,20160328 01:31:27 EST,31428.57,,BTCUSD,long,,20160328 01:16:06 EST,closed,20160328 01:16:06 EST,30249.56,,,1.0,1.0,,BTCUSD,,11790100.0,-1.0,465732051.75,1541953.25,24697900.0,791665300.0
218.0,4751539.5,20160328 03:01:46 EST,20160328 03:01:46 EST,20160328 03:01:46 EST,30797.85,,BTCUSD,short,,20160328 01:31:27 EST,closed,20160328 01:31:27 EST,31428.57,,,1.0,1.0,,BTCUSD,,6307200.0,1.0,470483591.25,1555660.5,18390700.0,797972500.0
219.0,-5495478.75,20160328 03:45:48 EST,20160328 03:45:48 EST,20160328 03:45:48 EST,30401.3,,BTCUSD,long,,20160328 03:01:46 EST,closed,20160328 03:01:46 EST,30797.85,,,1.0,1.0,,BTCUSD,,-3965500.0,-1.0,464988112.5,1529978.75,14425200.0,794007000.0
220.0,-1363374.25,20160328 04:01:38 EST,20160328 04:01:38 EST,20160328 04:01:38 EST,30385.67,,BTCUSD,short,,20160328 03:45:48 EST,closed,20160328 03:45:48 EST,30401.3,,,1.0,1.0,,BTCUSD,,156300.0,1.0,463624738.25,1519674.25,14268900.0,794163300.0
221.0,-2343617.5,20160328 04:32:04 EST,20160328 04:32:04 EST,20160328 04:32:04 EST,30303.03,,BTCUSD,long,,20160328 04:01:38 EST,closed,20160328 04:01:38 EST,30385.67,,,1.0,1.0,,BTCUSD,,-826400.0,-1.0,461281120.75,1517217.5,13442500.0,793336900.0
222.0,3813637.25,20160328 06:00:58 EST,20160328 06:00:58 EST,20160328 06:00:58 EST,29771.48,,BTCUSD,short,,20160328 04:32:04 EST,closed,20160328 04:32:04 EST,30303.03,,,1.0,1.0,,BTCUSD,,5315500.0,1.0,465094758.0,1501862.75,8127000.0,798652400.0
223.0,1540933.25,20160328 06:17:19 EST,20160328 06:17:19 EST,20160328 06:17:19 EST,30075.19,,BTCUSD,long,,20160328 06:00:58 EST,closed,20160328 06:00:58 EST,29771.48,,,1.0,1.0,,BTCUSD,,3037100.0,-1.0,466635691.25,1496166.75,11164100.0,801689500.0
224.0,-5640174.75,20160328 06:32:15 EST,20160328 06:32:15 EST,20160328 06:32:15 EST,30487.8,,BTCUSD,short,,20160328 06:17:19 EST,closed,20160328 06:17:19 EST,30075.19,,,1.0,1.0,,BTCUSD,,-4126100.0,1.0,460995516.5,1514074.75,15290200.0,797563400.0
225.0,341433.75,20160328 07:31:02 EST,20160328 07:31:02 EST,20160328 07:31:02 EST,30674.85,,BTCUSD,long,,20160328 06:32:15 EST,closed,20160328 06:32:15 EST,30487.8,,,1.0,1.0,,BTCUSD,,1870500.0,-1.0,461336950.25,1529066.25,17160700.0,799433900.0
226.0,8840628.75,20160328 07:50:00 EST,20160328 07:50:00 EST,20160328 07:50:00 EST,29640.0,,BTCUSD,short,,20160328 07:31:02 EST,closed,20160328 07:31:02 EST,30674.85,,,1.0,1.0,,BTCUSD,,10348500.0,1.0,470177579.0,1507871.25,6812200.0,809782400.0
227.0,8064474.0,20160328 08:17:33 EST,20160328 08:17:33 EST,20160328 08:17:33 EST,30597.04,,BTCUSD,long,,20160328 07:50:00 EST,closed,20160328 07:50:00 EST,29640.0,,,1.0,1.0,,BTCUSD,,9570400.0,-1.0,478242053.0,1505926.0,16382600.0,819352800.0
228.0,3613073.25,20160328 08:32:37 EST,20160328 08:32:37 EST,20160328 08:32:37 EST,30084.03,,BTCUSD,short,,20160328 08:17:33 EST,closed,20160328 08:17:33 EST,30597.04,,,1.0,1.0,,BTCUSD,,5130100.0,1.0,481855126.25,1517026.75,11252500.0,824482900.0
229.0,1811887.5,20160328 09:17:00 EST,20160328 09:17:00 EST,20160328 09:17:00 EST,30416.47,,BTCUSD,long,,20160328 08:32:37 EST,closed,20160328 08:32:37 EST,30084.03,,,1.0,1.0,,BTCUSD,,3324400.0,-1.0,483667013.75,1512512.5,14576900.0,827807300.0
230.0,5632014.0,20160328 09:31:59 EST,20160328 09:31:59 EST,20160328 09:31:59 EST,29702.97,,BTCUSD,short,,20160328 09:17:00 EST,closed,20160328 09:17:00 EST,30416.47,,,1.0,1.0,,BTCUSD,,7135000.0,1.0,489299027.75,1502986.0,7441900.0,834942300.0
231.0,2498667.0,20160328 09:47:35 EST,20160328 09:47:35 EST,20160328 09:47:35 EST,30102.35,,BTCUSD,long,,20160328 09:31:59 EST,closed,20160328 09:31:59 EST,29702.97,,,1.0,1.0,,BTCUSD,,3993800.0,-1.0,491797694.75,1495133.0,11435700.0,838936100.0
232.0,2772650.25,20160328 10:02:52 EST,20160328 10:02:52 EST,20160328 10:02:52 EST,29675.64,,BTCUSD,short,,20160328 09:47:35 EST,closed,20160328 09:47:35 EST,30102.35,,,1.0,1.0,,BTCUSD,,4267100.0,1.0,494570345.0,1494449.75,7168600.0,843203200.0
233.0,-1466026.5,20160328 10:18:02 EST,20160328 10:18:02 EST,20160328 10:18:02 EST,29677.42,,BTCUSD,long,,20160328 10:02:52 EST,closed,20160328 10:02:52 EST,29675.64,,,1.0,1.0,,BTCUSD,,17800.0,-1.0,493104318.5,1483826.5,7186400.0,843221000.0
234.0,-5532768.0,20160328 10:47:15 EST,20160328 10:47:15 EST,20160328 10:47:15 EST,30081.3,,BTCUSD,short,,20160328 10:18:02 EST,closed,20160328 10:18:02 EST,29677.42,,,1.0,1.0,,BTCUSD,,-4038800.0,1.0,487571550.5,1493968.0,11225200.0,839182200.0
235.0,-16565018.25,20160328 11:00:58 EST,20160328 11:00:58 EST,20160328 11:00:58 EST,28571.43,,BTCUSD,long,,20160328 10:47:15 EST,closed,20160328 10:47:15 EST,30081.3,,,1.0,1.0,,BTCUSD,,-15098700.0,-1.0,471006532.25,1466318.25,-3873500.0,824083500.0
236.0,-12938975.75,20160328 11:34:22 EST,20160328 11:34:22 EST,20160328 11:34:22 EST,29719.6,,BTCUSD,short,,20160328 11:00:58 EST,closed,20160328 11:00:58 EST,28571.43,,,1.0,1.0,,BTCUSD,,-11481700.0,1.0,458067556.5,1457275.75,7608200.0,812601800.0
237.0,5868088.75,20160328 11:50:33 EST,20160328 11:50:33 EST,20160328 11:50:33 EST,30456.85,,BTCUSD,long,,20160328 11:34:22 EST,closed,20160328 11:34:22 EST,29719.6,,,1.0,1.0,,BTCUSD,,7372500.0,-1.0,463935645.25,1504411.25,14980700.0,819974300.0
238.0,5766535.5,20160328 13:02:57 EST,20160328 13:02:57 EST,20160328 13:02:57 EST,29729.73,,BTCUSD,short,,20160328 11:50:33 EST,closed,20160328 11:50:33 EST,30456.85,,,1.0,1.0,,BTCUSD,,7271200.0,1.0,469702180.75,1504664.5,7709500.0,827245500.0
239.0,4299512.25,20160328 13:16:54 EST,20160328 13:16:54 EST,20160328 13:16:54 EST,30309.78,,BTCUSD,long,,20160328 13:02:57 EST,closed,20160328 13:02:57 EST,29729.73,,,1.0,1.0,,BTCUSD,,5800500.0,-1.0,474001693.0,1500987.75,13510000.0,833046000.0
240.0,-1857542.0,20160328 14:02:20 EST,20160328 14:02:20 EST,20160328 14:02:20 EST,30343.9,,BTCUSD,short,,20160328 13:16:54 EST,closed,20160328 13:16:54 EST,30309.78,,,1.0,1.0,,BTCUSD,,-341200.0,1.0,472144151.0,1516342.0,13851200.0,832704800.0
241.0,10802428.75,20160328 14:17:33 EST,20160328 14:17:33 EST,20160328 14:17:33 EST,31578.95,,BTCUSD,long,,20160328 14:02:20 EST,closed,20160328 14:02:20 EST,30343.9,,,1.0,1.0,,BTCUSD,,12350500.0,-1.0,482946579.75,1548071.25,26201700.0,845055300.0
242.0,10685236.5,20160328 14:31:43 EST,20160328 14:31:43 EST,20160328 14:31:43 EST,30355.59,,BTCUSD,short,,20160328 14:17:33 EST,closed,20160328 14:17:33 EST,31578.95,,,1.0,1.0,,BTCUSD,,12233600.0,1.0,493631816.25,1548363.5,13968100.0,857288900.0
243.0,-6765427.5,20160328 14:46:37 EST,20160328 14:46:37 EST,20160328 14:46:37 EST,29829.51,,BTCUSD,long,,20160328 14:31:43 EST,closed,20160328 14:31:43 EST,30355.59,,,1.0,1.0,,BTCUSD,,-5260800.0,-1.0,486866388.75,1504627.5,8707300.0,852028100.0
244.0,9701537.25,20160328 15:16:15 EST,20160328 15:16:15 EST,20160328 15:16:15 EST,28713.0,,BTCUSD,short,,20160328 14:46:37 EST,closed,20160328 14:46:37 EST,29829.51,,,1.0,1.0,,BTCUSD,,11165100.0,1.0,496567926.0,1463562.75,-2457800.0,863193200.0
245.0,13594480.5,20160328 16:18:04 EST,20160328 16:18:04 EST,20160328 16:18:04 EST,30219.78,,BTCUSD,long,,20160328 15:16:15 EST,closed,20160328 15:16:15 EST,28713.0,,,1.0,1.0,,BTCUSD,,15067800.0,-1.0,510162406.5,1473319.5,12610000.0,878261000.0
246.0,-1534146.75,20160328 16:48:17 EST,20160328 16:48:17 EST,20160328 16:48:17 EST,30222.09,,BTCUSD,short,,20160328 16:18:04 EST,closed,20160328 16:18:04 EST,30219.78,,,1.0,1.0,,BTCUSD,,-23100.0,1.0,508628259.75,1511046.75,12633100.0,878237900.0
247.0,-703728.0,20160328 17:05:38 EST,20160328 17:05:38 EST,20160328 17:05:38 EST,30303.03,,BTCUSD,long,,20160328 16:48:17 EST,closed,20160328 16:48:17 EST,30222.09,,,1.0,1.0,,BTCUSD,,809400.0,-1.0,507924531.75,1513128.0,13442500.0,879047300.0
248.0,7419830.25,20160328 17:15:54 EST,20160328 17:15:54 EST,20160328 17:15:54 EST,29411.76,,BTCUSD,short,,20160328 17:05:38 EST,closed,20160328 17:05:38 EST,30303.03,,,1.0,1.0,,BTCUSD,,8912700.0,1.0,515344362.0,1492869.75,4529800.0,887960000.0
249.0,8954184.75,20160328 18:17:29 EST,20160328 18:17:29 EST,20160328 18:17:29 EST,30456.85,,BTCUSD,long,,20160328 17:15:54 EST,closed,20160328 17:15:54 EST,29411.76,,,1.0,1.0,,BTCUSD,,10450900.0,-1.0,524298546.75,1496715.25,14980700.0,898410900.0
250.0,21583278.75,20160328 18:46:13 EST,20160328 18:46:13 EST,20160328 18:46:13 EST,28152.0,,BTCUSD,short,,20160328 18:17:29 EST,closed,20160328 18:17:29 EST,30456.85,,,1.0,1.0,,BTCUSD,,23048500.0,1.0,545881825.5,1465221.25,-8067800.0,921459400.0
251.0,20517450.0,20160328 19:02:35 EST,20160328 19:02:35 EST,20160328 19:02:35 EST,30350.0,,BTCUSD,long,,20160328 18:46:13 EST,closed,20160328 18:46:13 EST,28152.0,,,1.0,1.0,,BTCUSD,,21980000.0,-1.0,566399275.5,1462550.0,13912200.0,943439400.0
252.0,-2898945.0,20160328 19:20:52 EST,20160328 19:20:52 EST,20160328 19:20:52 EST,30487.8,,BTCUSD,short,,20160328 19:02:35 EST,closed,20160328 19:02:35 EST,30350.0,,,1.0,1.0,,BTCUSD,,-1378000.0,1.0,563500330.5,1520945.0,15290200.0,942061400.0
253.0,259838.25,20160328 19:31:30 EST,20160328 19:31:30 EST,20160328 19:31:30 EST,30666.67,,BTCUSD,long,,20160328 19:20:52 EST,closed,20160328 19:20:52 EST,30487.8,,,1.0,1.0,,BTCUSD,,1788700.0,-1.0,563760168.75,1528861.75,17078900.0,943850100.0
254.0,15275283.25,20160328 19:47:26 EST,20160328 19:47:26 EST,20160328 19:47:26 EST,28990.0,,BTCUSD,short,,20160328 19:31:30 EST,closed,20160328 19:31:30 EST,30666.67,,,1.0,1.0,,BTCUSD,,16766700.0,1.0,579035452.0,1491416.75,312200.0,960616800.0
255.0,17082853.0,20160328 20:03:24 EST,20160328 20:03:24 EST,20160328 20:03:24 EST,30847.88,,BTCUSD,long,,20160328 19:47:26 EST,closed,20160328 19:47:26 EST,28990.0,,,1.0,1.0,,BTCUSD,,18578800.0,-1.0,596118305.0,1495947.0,18891000.0,979195600.0
256.0,-5279513.5,20160328 20:16:59 EST,20160328 20:16:59 EST,20160328 20:16:59 EST,31220.66,,BTCUSD,short,,20160328 20:03:24 EST,closed,20160328 20:03:24 EST,30847.88,,,1.0,1.0,,BTCUSD,,-3727800.0,1.0,590838791.5,1551713.5,22618800.0,975467800.0
257.0,-1313254.0,20160328 21:33:10 EST,20160328 21:33:10 EST,20160328 21:33:10 EST,31245.5,,BTCUSD,long,,20160328 20:16:59 EST,closed,20160328 20:16:59 EST,31220.66,,,1.0,1.0,,BTCUSD,,248400.0,-1.0,589525537.5,1561654.0,22867200.0,975716200.0
258.0,12349217.0,20160328 21:46:50 EST,20160328 21:46:50 EST,20160328 21:46:50 EST,29857.82,,BTCUSD,short,,20160328 21:33:10 EST,closed,20160328 21:33:10 EST,31245.5,,,1.0,1.0,,BTCUSD,,13876800.0,1.0,601874754.5,1527583.0,8990400.0,989593000.0
259.0,14848553.0,20160328 22:32:42 EST,20160328 22:32:42 EST,20160328 22:32:42 EST,31496.06,,BTCUSD,long,,20160328 21:46:50 EST,closed,20160328 21:46:50 EST,29857.82,,,1.0,1.0,,BTCUSD,,16382400.0,-1.0,616723307.5,1533847.0,25372800.0,1005975400.0
260.0,8193757.5,20160329 00:18:04 EST,20160329 00:18:04 EST,20160329 00:18:04 EST,30521.64,,BTCUSD,short,,20160328 22:32:42 EST,closed,20160328 22:32:42 EST,31496.06,,,1.0,1.0,,BTCUSD,,9744200.0,1.0,624917065.0,1550442.5,15628600.0,1015719600.0
261.0,-2565975.75,20160329 00:47:24 EST,20160329 00:47:24 EST,20160329 00:47:24 EST,30417.39,,BTCUSD,long,,20160329 00:18:04 EST,closed,20160329 00:18:04 EST,30521.64,,,1.0,1.0,,BTCUSD,,-1042500.0,-1.0,622351089.25,1523475.75,14586100.0,1014677100.0
262.0,3369425.75,20160329 01:47:27 EST,20160329 01:47:27 EST,20160329 01:47:27 EST,29929.58,,BTCUSD,short,,20160329 00:47:24 EST,closed,20160329 00:47:24 EST,30417.39,,,1.0,1.0,,BTCUSD,,4878100.0,1.0,625720515.0,1508674.25,9708000.0,1019555200.0
263.0,194981.75,20160329 02:06:50 EST,20160329 02:06:50 EST,20160329 02:06:50 EST,30099.15,,BTCUSD,long,,20160329 01:47:27 EST,closed,20160329 01:47:27 EST,29929.58,,,1.0,1.0,,BTCUSD,,1695700.0,-1.0,625915496.75,1500718.25,11403700.0,1021250900.0
264.0,9514021.25,20160329 02:18:37 EST,20160329 02:18:37 EST,20160329 02:18:37 EST,29000.0,,BTCUSD,short,,20160329 02:06:50 EST,closed,20160329 02:06:50 EST,30099.15,,,1.0,1.0,,BTCUSD,,10991500.0,1.0,635429518.0,1477478.75,412200.0,1032242400.0
265.0,9545941.25,20160329 02:35:04 EST,20160329 02:35:04 EST,20160329 02:35:04 EST,30102.35,,BTCUSD,long,,20160329 02:18:37 EST,closed,20160329 02:18:37 EST,29000.0,,,1.0,1.0,,BTCUSD,,11023500.0,-1.0,644975459.25,1477558.75,11435700.0,1043265900.0
266.0,-1686870.75,20160329 02:47:29 EST,20160329 02:47:29 EST,20160329 02:47:29 EST,30120.48,,BTCUSD,short,,20160329 02:35:04 EST,closed,20160329 02:35:04 EST,30102.35,,,1.0,1.0,,BTCUSD,,-181300.0,1.0,643288588.5,1505570.75,11617000.0,1043084600.0
267.0,-12682812.0,20160329 03:05:03 EST,20160329 03:05:03 EST,20160329 03:05:03 EST,29000.0,,BTCUSD,long,,20160329 02:47:29 EST,closed,20160329 02:47:29 EST,30120.48,,,1.0,1.0,,BTCUSD,,-11204800.0,-1.0,630605776.5,1478012.0,412200.0,1031879800.0
268.0,7974101.5,20160329 04:06:40 EST,20160329 04:06:40 EST,20160329 04:06:40 EST,28059.94,,BTCUSD,short,,20160329 03:05:03 EST,closed,20160329 03:05:03 EST,29000.0,,,1.0,1.0,,BTCUSD,,9400600.0,1.0,638579878.0,1426498.5,-8988400.0,1041280400.0
269.0,17863615.75,20160329 04:33:53 EST,20160329 04:33:53 EST,20160329 04:33:53 EST,29991.43,,BTCUSD,long,,20160329 04:06:40 EST,closed,20160329 04:06:40 EST,28059.94,,,1.0,1.0,,BTCUSD,,19314900.0,-1.0,656443493.75,1451284.25,10326500.0,1060595300.0
270.0,5782.5,20160329 04:47:37 EST,20160329 04:47:37 EST,20160329 04:47:37 EST,29841.27,,BTCUSD,short,,20160329 04:33:53 EST,closed,20160329 04:33:53 EST,29991.43,,,1.0,1.0,,BTCUSD,,1501600.0,1.0,656449276.25,1495817.5,8824900.0,1062096900.0
271.0,2099634.75,20160329 06:03:23 EST,20160329 06:03:23 EST,20160329 06:03:23 EST,30201.34,,BTCUSD,long,,20160329 04:47:37 EST,closed,20160329 04:47:37 EST,29841.27,,,1.0,1.0,,BTCUSD,,3600700.0,-1.0,658548911.0,1501065.25,12425600.0,1065697600.0
272.0,443003.5,20160329 06:38:18 EST,20160329 06:38:18 EST,20160329 06:38:18 EST,30006.52,,BTCUSD,short,,20160329 06:03:23 EST,closed,20160329 06:03:23 EST,30201.34,,,1.0,1.0,,BTCUSD,,1948200.0,1.0,658991914.5,1505196.5,10477400.0,1067645800.0
273.0,-1643467.25,20160329 07:05:47 EST,20160329 07:05:47 EST,20160329 07:05:47 EST,29992.17,,BTCUSD,long,,20160329 06:38:18 EST,closed,20160329 06:38:18 EST,30006.52,,,1.0,1.0,,BTCUSD,,-143500.0,-1.0,657348447.25,1499967.25,10333900.0,1067502300.0
274.0,-488386.75,20160329 07:20:12 EST,20160329 07:20:12 EST,20160329 07:20:12 EST,29891.3,,BTCUSD,short,,20160329 07:05:47 EST,closed,20160329 07:05:47 EST,29992.17,,,1.0,1.0,,BTCUSD,,1008700.0,1.0,656860060.5,1497086.75,9325200.0,1068511000.0
275.0,-1404490.75,20160329 07:35:15 EST,20160329 07:35:15 EST,20160329 07:35:15 EST,29900.33,,BTCUSD,long,,20160329 07:20:12 EST,closed,20160329 07:20:12 EST,29891.3,,,1.0,1.0,,BTCUSD,,90300.0,-1.0,655455569.75,1494790.75,9415500.0,1068601300.0
276.0,9836541.75,20160329 07:48:34 EST,20160329 07:48:34 EST,20160329 07:48:34 EST,28770.0,,BTCUSD,short,,20160329 07:35:15 EST,closed,20160329 07:35:15 EST,29900.33,,,1.0,1.0,,BTCUSD,,11303300.0,1.0,665292111.5,1466758.25,-1887800.0,1079904600.0
277.0,8134806.75,20160329 08:33:56 EST,20160329 08:33:56 EST,20160329 08:33:56 EST,29729.73,,BTCUSD,long,,20160329 07:48:34 EST,closed,20160329 07:48:34 EST,28770.0,,,1.0,1.0,,BTCUSD,,9597300.0,-1.0,673426918.25,1462493.25,7709500.0,1089501900.0
278.0,12156937.0,20160329 09:03:36 EST,20160329 09:03:36 EST,20160329 09:03:36 EST,28368.79,,BTCUSD,short,,20160329 08:33:56 EST,closed,20160329 08:33:56 EST,29729.73,,,1.0,1.0,,BTCUSD,,13609400.0,1.0,685583855.25,1452463.0,-5899900.0,1103111300.0
279.0,16572670.0,20160329 09:36:55 EST,20160329 09:36:55 EST,20160329 09:36:55 EST,30172.41,,BTCUSD,long,,20160329 09:03:36 EST,closed,20160329 09:03:36 EST,28368.79,,,1.0,1.0,,BTCUSD,,18036200.0,-1.0,702156525.25,1463530.0,12136300.0,1121147500.0
280.0,-9882904.0,20160329 09:46:53 EST,20160329 09:46:53 EST,20160329 09:46:53 EST,31007.75,,BTCUSD,short,,20160329 09:36:55 EST,closed,20160329 09:36:55 EST,30172.41,,,1.0,1.0,,BTCUSD,,-8353400.0,1.0,692273621.25,1529504.0,20489700.0,1112794100.0
281.0,-11944337.5,20160329 10:03:26 EST,20160329 10:03:26 EST,20160329 10:03:26 EST,29965.75,,BTCUSD,long,,20160329 09:46:53 EST,closed,20160329 09:46:53 EST,31007.75,,,1.0,1.0,,BTCUSD,,-10420000.0,-1.0,680329283.75,1524337.5,10069700.0,1102374100.0
282.0,2310711.25,20160329 10:20:45 EST,20160329 10:20:45 EST,20160329 10:20:45 EST,29585.8,,BTCUSD,short,,20160329 10:03:26 EST,closed,20160329 10:03:26 EST,29965.75,,,1.0,1.0,,BTCUSD,,3799500.0,1.0,682639995.0,1488788.75,6270200.0,1106173600.0
283.0,424638.25,20160329 10:34:20 EST,20160329 10:34:20 EST,20160329 10:34:20 EST,29776.67,,BTCUSD,long,,20160329 10:20:45 EST,closed,20160329 10:20:45 EST,29585.8,,,1.0,1.0,,BTCUSD,,1908700.0,-1.0,683064633.25,1484061.75,8178900.0,1108082300.0
284.0,8480527.75,20160329 10:47:50 EST,20160329 10:47:50 EST,20160329 10:47:50 EST,28782.22,,BTCUSD,short,,20160329 10:34:20 EST,closed,20160329 10:34:20 EST,29776.67,,,1.0,1.0,,BTCUSD,,9944500.0,1.0,691545161.0,1463972.25,-1765600.0,1118026800.0
285.0,4165841.5,20160329 11:04:12 EST,20160329 11:04:12 EST,20160329 11:04:12 EST,29344.12,,BTCUSD,long,,20160329 10:47:50 EST,closed,20160329 10:47:50 EST,28782.22,,,1.0,1.0,,BTCUSD,,5619000.0,-1.0,695711002.5,1453158.5,3853400.0,1123645800.0
286.0,-6084821.25,20160329 11:17:48 EST,20160329 11:17:48 EST,20160329 11:17:48 EST,29804.73,,BTCUSD,short,,20160329 11:04:12 EST,closed,20160329 11:04:12 EST,29344.12,,,1.0,1.0,,BTCUSD,,-4606100.0,1.0,689626181.25,1478721.25,8459500.0,1119039700.0
287.0,457581.75,20160329 11:31:33 EST,20160329 11:31:33 EST,20160329 11:31:33 EST,30000.0,,BTCUSD,long,,20160329 11:17:48 EST,closed,20160329 11:17:48 EST,29804.73,,,1.0,1.0,,BTCUSD,,1952700.0,-1.0,690083763.0,1495118.25,10412200.0,1120992400.0
288.0,-899703.0,20160329 11:48:45 EST,20160329 11:48:45 EST,20160329 11:48:45 EST,29940.12,,BTCUSD,short,,20160329 11:31:33 EST,closed,20160329 11:31:33 EST,30000.0,,,1.0,1.0,,BTCUSD,,598800.0,1.0,689184060.0,1498503.0,9813400.0,1121591200.0
289.0,-5031348.0,20160329 12:19:19 EST,20160329 12:19:19 EST,20160329 12:19:19 EST,29585.8,,BTCUSD,long,,20160329 11:48:45 EST,closed,20160329 11:48:45 EST,29940.12,,,1.0,1.0,,BTCUSD,,-3543200.0,-1.0,684152712.0,1488148.0,6270200.0,1118048000.0
290.0,-3792157.75,20160329 12:33:27 EST,20160329 12:33:27 EST,20160329 12:33:27 EST,29816.51,,BTCUSD,short,,20160329 12:19:19 EST,closed,20160329 12:19:19 EST,29585.8,,,1.0,1.0,,BTCUSD,,-2307100.0,1.0,680360554.25,1485057.75,8577300.0,1115740900.0
291.0,2283515.0,20160329 12:47:44 EST,20160329 12:47:44 EST,20160329 12:47:44 EST,30194.89,,BTCUSD,long,,20160329 12:33:27 EST,closed,20160329 12:33:27 EST,29816.51,,,1.0,1.0,,BTCUSD,,3783800.0,-1.0,682644069.25,1500285.0,12361100.0,1119524700.0
292.0,-1554155.25,20160329 13:33:20 EST,20160329 13:33:20 EST,20160329 13:33:20 EST,30199.32,,BTCUSD,short,,20160329 12:47:44 EST,closed,20160329 12:47:44 EST,30194.89,,,1.0,1.0,,BTCUSD,,-44300.0,1.0,681089914.0,1509855.25,12405400.0,1119480400.0
293.0,-1933903.5,20160329 13:51:02 EST,20160329 13:51:02 EST,20160329 13:51:02 EST,30156.82,,BTCUSD,long,,20160329 13:33:20 EST,closed,20160329 13:33:20 EST,30199.32,,,1.0,1.0,,BTCUSD,,-425000.0,-1.0,679156010.5,1508903.5,11980400.0,1119055400.0
294.0,-1636963.0,20160329 14:18:58 EST,20160329 14:18:58 EST,20160329 14:18:58 EST,30169.7,,BTCUSD,short,,20160329 13:51:02 EST,closed,20160329 13:51:02 EST,30156.82,,,1.0,1.0,,BTCUSD,,-128800.0,1.0,677519047.5,1508163.0,12109200.0,1118926600.0
295.0,-6302968.75,20160329 14:48:01 EST,20160329 14:48:01 EST,20160329 14:48:01 EST,29689.05,,BTCUSD,long,,20160329 14:18:58 EST,closed,20160329 14:18:58 EST,30169.7,,,1.0,1.0,,BTCUSD,,-4806500.0,-1.0,671216078.75,1496468.75,7302700.0,1114120100.0
296.0,-38018359.5,20160329 15:02:16 EST,20160329 15:02:16 EST,20160329 15:02:16 EST,33333.33,,BTCUSD,short,,20160329 14:48:01 EST,closed,20160329 14:48:01 EST,29689.05,,,1.0,1.0,,BTCUSD,,-36442800.0,1.0,633197719.25,1575559.5,43745500.0,1077677300.0
297.0,-27714982.5,20160329 15:31:23 EST,20160329 15:31:23 EST,20160329 15:31:23 EST,30721.97,,BTCUSD,long,,20160329 15:02:16 EST,closed,20160329 15:02:16 EST,33333.33,,,1.0,1.0,,BTCUSD,,-26113600.0,-1.0,605482736.75,1601382.5,17631900.0,1051563700.0
298.0,9642077.25,20160329 16:19:05 EST,20160329 16:19:05 EST,20160329 16:19:05 EST,29606.94,,BTCUSD,short,,20160329 15:31:23 EST,closed,20160329 15:31:23 EST,30721.97,,,1.0,1.0,,BTCUSD,,11150300.0,1.0,615124814.0,1508222.75,6481600.0,1062714000.0
299.0,-940899.0,20160329 16:37:58 EST,20160329 16:37:58 EST,20160329 16:37:58 EST,29661.02,,BTCUSD,long,,20160329 16:19:05 EST,closed,20160329 16:19:05 EST,29606.94,,,1.0,1.0,,BTCUSD,,540800.0,-1.0,614183915.0,1481699.0,7022400.0,1063254800.0
300.0,9440088.75,20160329 17:31:27 EST,20160329 17:31:27 EST,20160329 17:31:27 EST,28571.43,,BTCUSD,short,,20160329 16:37:58 EST,closed,20160329 16:37:58 EST,29661.02,,,1.0,1.0,,BTCUSD,,10895900.0,1.0,623624003.75,1455811.25,-3873500.0,1074150700.0
301.0,15844138.5,20160329 17:50:29 EST,20160329 17:50:29 EST,20160329 17:50:29 EST,30303.03,,BTCUSD,long,,20160329 17:31:27 EST,closed,20160329 17:31:27 EST,28571.43,,,1.0,1.0,,BTCUSD,,17316000.0,-1.0,639468142.25,1471861.5,13442500.0,1091466700.0
302.0,14294574.25,20160329 18:17:18 EST,20160329 18:17:18 EST,20160329 18:17:18 EST,28726.0,,BTCUSD,short,,20160329 17:50:29 EST,closed,20160329 17:50:29 EST,30303.03,,,1.0,1.0,,BTCUSD,,15770300.0,1.0,653762716.5,1475725.75,-2327800.0,1107237000.0
303.0,6849433.75,20160329 18:32:49 EST,20160329 18:32:49 EST,20160329 18:32:49 EST,29556.65,,BTCUSD,long,,20160329 18:17:18 EST,closed,20160329 18:17:18 EST,28726.0,,,1.0,1.0,,BTCUSD,,8306500.0,-1.0,660612150.25,1457066.25,5978700.0,1115543500.0
304.0,6285126.5,20160329 19:32:26 EST,20160329 19:32:26 EST,20160329 19:32:26 EST,28782.29,,BTCUSD,short,,20160329 18:32:49 EST,closed,20160329 18:32:49 EST,29556.65,,,1.0,1.0,,BTCUSD,,7743600.0,1.0,666897276.75,1458473.5,-1764900.0,1123287100.0
305.0,11970178.25,20160329 19:48:13 EST,20160329 19:48:13 EST,20160329 19:48:13 EST,30126.58,,BTCUSD,long,,20160329 19:32:26 EST,closed,20160329 19:32:26 EST,28782.29,,,1.0,1.0,,BTCUSD,,13442900.0,-1.0,678867455.0,1472721.75,11678000.0,1136730000.0
306.0,362932.5,20160329 20:03:39 EST,20160329 20:03:39 EST,20160329 20:03:39 EST,29940.12,,BTCUSD,short,,20160329 19:48:13 EST,closed,20160329 19:48:13 EST,30126.58,,,1.0,1.0,,BTCUSD,,1864600.0,1.0,679230387.5,1501667.5,9813400.0,1138594600.0
307.0,-1497006.0,20160329 20:47:25 EST,20160329 20:47:25 EST,20160329 20:47:25 EST,29940.12,,BTCUSD,long,,20160329 20:03:39 EST,closed,20160329 20:03:39 EST,29940.12,,,1.0,1.0,,BTCUSD,,0.0,-1.0,677733381.5,1497006.0,9813400.0,1138594600.0
308.0,1399818.0,20160329 21:03:31 EST,20160329 21:03:31 EST,20160329 21:03:31 EST,29651.16,,BTCUSD,short,,20160329 20:47:25 EST,closed,20160329 20:47:25 EST,29940.12,,,1.0,1.0,,BTCUSD,,2889600.0,1.0,679133199.5,1489782.0,6923800.0,1141484200.0
309.0,8989695.75,20160329 21:19:50 EST,20160329 21:19:50 EST,20160329 21:19:50 EST,30701.01,,BTCUSD,long,,20160329 21:03:31 EST,closed,20160329 21:03:31 EST,29651.16,,,1.0,1.0,,BTCUSD,,10498500.0,-1.0,688122895.25,1508804.25,17422300.0,1151982700.0
310.0,6281943.25,20160329 21:31:56 EST,20160329 21:31:56 EST,20160329 21:31:56 EST,29921.26,,BTCUSD,short,,20160329 21:19:50 EST,closed,20160329 21:19:50 EST,30701.01,,,1.0,1.0,,BTCUSD,,7797500.0,1.0,694404838.5,1515556.75,9624800.0,1159780200.0
311.0,-1613169.5,20160329 22:19:09 EST,20160329 22:19:09 EST,20160329 22:19:09 EST,29909.52,,BTCUSD,long,,20160329 21:31:56 EST,closed,20160329 21:31:56 EST,29921.26,,,1.0,1.0,,BTCUSD,,-117400.0,-1.0,692791669.0,1495769.5,9507400.0,1159662800.0
312.0,-1250264.5,20160329 22:46:57 EST,20160329 22:46:57 EST,20160329 22:46:57 EST,29885.06,,BTCUSD,short,,20160329 22:19:09 EST,closed,20160329 22:19:09 EST,29909.52,,,1.0,1.0,,BTCUSD,,244600.0,1.0,691541404.5,1494864.5,9262800.0,1159907400.0
313.0,8686232.0,20160329 23:03:08 EST,20160329 23:03:08 EST,20160329 23:03:08 EST,30905.66,,BTCUSD,long,,20160329 22:46:57 EST,closed,20160329 22:46:57 EST,29885.06,,,1.0,1.0,,BTCUSD,,10206000.0,-1.0,700227636.5,1519768.0,19468800.0,1170113400.0
314.0,18461108.25,20160329 23:47:21 EST,20160329 23:47:21 EST,20160329 23:47:21 EST,28910.01,,BTCUSD,short,,20160329 23:03:08 EST,closed,20160329 23:03:08 EST,30905.66,,,1.0,1.0,,BTCUSD,,19956500.0,1.0,718688744.75,1495391.75,-487700.0,1190069900.0
315.0,18305398.5,20160330 00:03:39 EST,20160330 00:03:39 EST,20160330 00:03:39 EST,30890.05,,BTCUSD,long,,20160329 23:47:21 EST,closed,20160329 23:47:21 EST,28910.01,,,1.0,1.0,,BTCUSD,,19800400.0,-1.0,736994143.25,1495001.5,19312700.0,1209870300.0
316.0,8203005.5,20160330 00:16:06 EST,20160330 00:16:06 EST,20160330 00:16:06 EST,29917.73,,BTCUSD,short,,20160330 00:03:39 EST,closed,20160330 00:03:39 EST,30890.05,,,1.0,1.0,,BTCUSD,,9723200.0,1.0,745197148.75,1520194.5,9589500.0,1219593500.0
317.0,4312256.75,20160330 00:48:49 EST,20160330 00:48:49 EST,20160330 00:48:49 EST,30500.0,,BTCUSD,long,,20160330 00:16:06 EST,closed,20160330 00:16:06 EST,29917.73,,,1.0,1.0,,BTCUSD,,5822700.0,-1.0,749509405.5,1510443.25,15412200.0,1225416200.0
318.0,26522343.5,20160330 01:05:04 EST,20160330 01:05:04 EST,20160330 01:05:04 EST,27702.26,,BTCUSD,short,,20160330 00:48:49 EST,closed,20160330 00:48:49 EST,30500.0,,,1.0,1.0,,BTCUSD,,27977400.0,1.0,776031749.0,1455056.5,-12565200.0,1253393600.0
319.0,20788613.75,20160330 01:21:09 EST,20160330 01:21:09 EST,20160330 01:21:09 EST,29925.19,,BTCUSD,long,,20160330 01:05:04 EST,closed,20160330 01:05:04 EST,27702.26,,,1.0,1.0,,BTCUSD,,22229300.0,-1.0,796820362.75,1440686.25,9664100.0,1275622900.0
320.0,362475.75,20160330 01:45:45 EST,20160330 01:45:45 EST,20160330 01:45:45 EST,29739.78,,BTCUSD,short,,20160330 01:21:09 EST,closed,20160330 01:21:09 EST,29925.19,,,1.0,1.0,,BTCUSD,,1854100.0,1.0,797182838.5,1491624.25,7810000.0,1277477000.0
321.0,406266.0,20160330 02:05:57 EST,20160330 02:05:57 EST,20160330 02:05:57 EST,29929.58,,BTCUSD,long,,20160330 01:45:45 EST,closed,20160330 01:45:45 EST,29739.78,,,1.0,1.0,,BTCUSD,,1898000.0,-1.0,797589104.5,1491734.0,9708000.0,1279375000.0
322.0,-1112722.0,20160330 02:39:05 EST,20160330 02:39:05 EST,20160330 02:39:05 EST,29891.3,,BTCUSD,short,,20160330 02:05:57 EST,closed,20160330 02:05:57 EST,29929.58,,,1.0,1.0,,BTCUSD,,382800.0,1.0,796476382.5,1495522.0,9325200.0,1279757800.0
323.0,4057619.75,20160330 02:47:28 EST,20160330 02:47:28 EST,20160330 02:47:28 EST,30447.91,,BTCUSD,long,,20160330 02:39:05 EST,closed,20160330 02:39:05 EST,29891.3,,,1.0,1.0,,BTCUSD,,5566100.0,-1.0,800534002.25,1508480.25,14891300.0,1285323900.0
324.0,6680861.5,20160330 03:03:50 EST,20160330 03:03:50 EST,20160330 03:03:50 EST,29629.63,,BTCUSD,short,,20160330 02:47:28 EST,closed,20160330 02:47:28 EST,30447.91,,,1.0,1.0,,BTCUSD,,8182800.0,1.0,807214863.75,1501938.5,6708500.0,1293506700.0
325.0,-85380.5,20160330 03:33:04 EST,20160330 03:33:04 EST,20160330 03:33:04 EST,29769.59,,BTCUSD,long,,20160330 03:03:50 EST,closed,20160330 03:03:50 EST,29629.63,,,1.0,1.0,,BTCUSD,,1399600.0,-1.0,807129483.25,1484980.5,8108100.0,1294906300.0
326.0,-85380.5,20160330 04:16:03 EST,20160330 04:16:03 EST,20160330 04:16:03 EST,29629.63,,BTCUSD,short,,20160330 03:33:04 EST,closed,20160330 03:33:04 EST,29769.59,,,1.0,1.0,,BTCUSD,,1399600.0,1.0,807044102.75,1484980.5,6708500.0,1296305900.0
327.0,-740740.75,,,,0.0,,BTCUSD,long,,20160330 04:16:03 EST,open,20160330 04:16:03 EST,29629.63,,,0.0,1.0,,BTCUSD,,0.0,1.0,806303362.0,740740.75,-289587800.0,1296305900.0
