trade_id,PL,closeVWAP_timestamp,closedWhen,closedWhenUnixTimeStamp,closing_price_VWAP,expir,instrument,long_or_short,markToMarket_time,openVWAP_timestamp,open_or_closed,openedWhen,opening_price_VWAP,ptValue,putcall,quant_closed,quant_opened,strike,symbol,symbol_description,PurePL,qty,currency,balance,commission,margin_available,mark_to_mkt,pure_mark_to_mkt,purebalance,pure_unr_pnl,unr_pnl
1.0,408.97245,20160410 09:17:39 EST,20160410 09:17:39 EST,20160410 09:17:39 EST,29548.43,,BTCUSD_localbtcRUB,long,,20160410 09:01:12 EST,closed,20160410 09:01:12 EST,29197.08,,,2.0,2.0,,BTCUSD_localbtcRUB,,702.7,-2.0,USD,100408.97245,293.72755,2000702.7,100408.97245,100702.7,100702.7,0.0,-145.9854
2.0,-901.6359,20160410 09:46:38 EST,20160410 09:46:38 EST,20160410 09:46:38 EST,29850.75,,BTCUSD_localbtcRUB,short,,20160410 09:17:39 EST,closed,20160410 09:17:39 EST,29548.43,,,2.0,2.0,,BTCUSD_localbtcRUB,,-604.64,2.0,USD,99507.33655,296.9959,2001307.34,99507.33655,100098.06,100098.06,0.0,-147.74215
3.0,-0.75375,20160410 10:31:57 EST,20160410 10:31:57 EST,20160410 10:31:57 EST,30000.0,,BTCUSD_localbtcRUB,long,,20160410 09:46:38 EST,closed,20160410 09:46:38 EST,29850.75,,,2.0,2.0,,BTCUSD_localbtcRUB,,298.5,-2.0,USD,99506.5828,299.25375,2001605.84,99506.5828,100396.56,100396.56,0.0,-149.25375
4.0,1248.7422,20160410 11:02:54 EST,20160410 11:02:54 EST,20160410 11:02:54 EST,29227.56,,BTCUSD_localbtcRUB,short,,20160410 10:31:57 EST,closed,20160410 10:31:57 EST,30000.0,,,2.0,2.0,,BTCUSD_localbtcRUB,,1544.88,2.0,USD,100755.325,296.1378,2000060.96,100755.325,101941.44,101941.44,0.0,-150.0
5.0,591.05055,20160410 11:17:26 EST,20160410 11:17:26 EST,20160410 11:17:26 EST,29670.33,,BTCUSD_localbtcRUB,long,,20160410 11:02:54 EST,closed,20160410 11:02:54 EST,29227.56,,,2.0,2.0,,BTCUSD_localbtcRUB,,885.54,-2.0,USD,101346.37555,294.48945,2000946.5,101346.37555,102826.98,102826.98,0.0,-146.1378
6.0,-99.51155,20160410 12:33:33 EST,20160410 12:33:33 EST,20160410 12:33:33 EST,29571.98,,BTCUSD_localbtcRUB,short,,20160410 11:17:26 EST,closed,20160410 11:17:26 EST,29670.33,,,2.0,2.0,,BTCUSD_localbtcRUB,,196.7,2.0,USD,101246.864,296.21155,2000749.8,101246.864,103023.68,103023.68,0.0,-148.35165
7.0,-2829.54935,20160410 12:46:33 EST,20160410 12:46:33 EST,20160410 12:46:33 EST,28301.89,,BTCUSD_localbtcRUB,long,,20160410 12:33:33 EST,closed,20160410 12:33:33 EST,29571.98,,,2.0,2.0,,BTCUSD_localbtcRUB,,-2540.18,-2.0,USD,98417.31465,289.36935,1998209.62,98417.31465,100483.5,100483.5,0.0,-147.8599
8.0,-1422.07945,20160410 13:17:21 EST,20160410 13:17:21 EST,20160410 13:17:21 EST,28870.0,,BTCUSD_localbtcRUB,short,,20160410 12:46:33 EST,closed,20160410 12:46:33 EST,28301.89,,,2.0,2.0,,BTCUSD_localbtcRUB,,-1136.22,2.0,USD,96995.2352,285.85945,1999345.84,96995.2352,99347.28,99347.28,0.0,-141.50945
9.0,-1585.45,20160410 13:31:13 EST,20160410 13:31:13 EST,20160410 13:31:13 EST,28220.0,,BTCUSD_localbtcRUB,long,,20160410 13:17:21 EST,closed,20160410 13:17:21 EST,28870.0,,,2.0,2.0,,BTCUSD_localbtcRUB,,-1300.0,-2.0,USD,95409.7852,285.45,1998045.84,95409.7852,98047.28,98047.28,0.0,-144.35
10.0,-1861.39815,20160410 13:49:03 EST,20160410 13:49:03 EST,20160410 13:49:03 EST,29007.63,,BTCUSD_localbtcRUB,short,,20160410 13:31:13 EST,closed,20160410 13:31:13 EST,28220.0,,,2.0,2.0,,BTCUSD_localbtcRUB,,-1575.26,2.0,USD,93548.38705,286.13815,1999621.1,93548.38705,96472.02,96472.02,0.0,-141.1
11.0,-922.91025,20160410 14:07:10 EST,20160410 14:07:10 EST,20160410 14:07:10 EST,28690.42,,BTCUSD_localbtcRUB,long,,20160410 13:49:03 EST,closed,20160410 13:49:03 EST,29007.63,,,2.0,2.0,,BTCUSD_localbtcRUB,,-634.42,-2.0,USD,92625.4768,288.49025,1998986.68,92625.4768,95837.6,95837.6,0.0,-145.03815
12.0,-1711.5369,20160410 15:17:37 EST,20160410 15:17:37 EST,20160410 15:17:37 EST,29400.96,,BTCUSD_localbtcRUB,short,,20160410 14:07:10 EST,closed,20160410 14:07:10 EST,28690.42,,,2.0,2.0,,BTCUSD_localbtcRUB,,-1421.08,2.0,USD,90913.9399,290.4569,2000407.76,90913.9399,94416.52,94416.52,0.0,-143.4521
13.0,-3006.2121,20160410 15:46:50 EST,20160410 15:46:50 EST,20160410 15:46:50 EST,28041.46,,BTCUSD_localbtcRUB,long,,20160410 15:17:37 EST,closed,20160410 15:17:37 EST,29400.96,,,2.0,2.0,,BTCUSD_localbtcRUB,,-2719.0,-2.0,USD,87907.7278,287.2121,1997688.76,87907.7278,91697.52,91697.52,0.0,-147.0048
14.0,-3552.83525,20160410 16:02:45 EST,20160410 16:02:45 EST,20160410 16:02:45 EST,29673.59,,BTCUSD_localbtcRUB,short,,20160410 15:46:50 EST,closed,20160410 15:46:50 EST,28041.46,,,2.0,2.0,,BTCUSD_localbtcRUB,,-3264.26,2.0,USD,84354.89255,288.57525,2000953.02,84354.89255,88433.26,88433.26,0.0,-140.2073
15.0,-1628.9171,20160410 16:31:58 EST,20160410 16:31:58 EST,20160410 16:31:58 EST,29005.83,,BTCUSD_localbtcRUB,long,,20160410 16:02:45 EST,closed,20160410 16:02:45 EST,29673.59,,,2.0,2.0,,BTCUSD_localbtcRUB,,-1335.52,-2.0,USD,82725.97545,293.3971,1999617.5,82725.97545,87097.74,87097.74,0.0,-148.36795
16.0,-268.90555,20160410 16:47:59 EST,20160410 16:47:59 EST,20160410 16:47:59 EST,28995.28,,BTCUSD_localbtcRUB,short,,20160410 16:31:58 EST,closed,20160410 16:31:58 EST,29005.83,,,2.0,2.0,,BTCUSD_localbtcRUB,,21.1,2.0,USD,82457.0699,290.00555,1999596.4,82457.0699,87118.84,87118.84,0.0,-145.02915
17.0,714.03095,20160410 17:18:00 EST,20160410 17:18:00 EST,20160410 17:18:00 EST,29498.53,,BTCUSD_localbtcRUB,long,,20160410 16:47:59 EST,closed,20160410 16:47:59 EST,28995.28,,,2.0,2.0,,BTCUSD_localbtcRUB,,1006.5,-2.0,USD,83171.10085,292.46905,2000602.9,83171.10085,88125.34,88125.34,0.0,-144.9764
18.0,-279.12575,20160410 17:31:32 EST,20160410 17:31:32 EST,20160410 17:31:32 EST,29490.62,,BTCUSD_localbtcRUB,short,,20160410 17:18:00 EST,closed,20160410 17:18:00 EST,29498.53,,,2.0,2.0,,BTCUSD_localbtcRUB,,15.82,2.0,USD,82891.9751,294.94575,2000587.08,82891.9751,88141.16,88141.16,0.0,-147.49265
19.0,-369.9182,20160410 17:50:33 EST,20160410 17:50:33 EST,20160410 17:50:33 EST,29453.02,,BTCUSD_localbtcRUB,long,,20160410 17:31:32 EST,closed,20160410 17:31:32 EST,29490.62,,,2.0,2.0,,BTCUSD_localbtcRUB,,-75.2,-2.0,USD,82522.0569,294.7182,2000511.88,82522.0569,88065.96,88065.96,0.0,-147.4531
20.0,-1764.8368,20160410 18:01:58 EST,20160410 18:01:58 EST,20160410 18:01:58 EST,30186.34,,BTCUSD_localbtcRUB,short,,20160410 17:50:33 EST,closed,20160410 17:50:33 EST,29453.02,,,2.0,2.0,,BTCUSD_localbtcRUB,,-1466.64,2.0,USD,80757.2201,298.1968,2001978.52,80757.2201,86599.32,86599.32,0.0,-147.2651
21.0,-1461.118,20160410 18:47:40 EST,20160410 18:47:40 EST,20160410 18:47:40 EST,29605.26,,BTCUSD_localbtcRUB,long,,20160410 18:01:58 EST,closed,20160410 18:01:58 EST,30186.34,,,2.0,2.0,,BTCUSD_localbtcRUB,,-1162.16,-2.0,USD,79296.1021,298.958,2000816.36,79296.1021,85437.16,85437.16,0.0,-150.9317
22.0,-273.356,20160410 19:01:30 EST,20160410 19:01:30 EST,20160410 19:01:30 EST,29593.94,,BTCUSD_localbtcRUB,short,,20160410 18:47:40 EST,closed,20160410 18:47:40 EST,29605.26,,,2.0,2.0,,BTCUSD_localbtcRUB,,22.64,2.0,USD,79022.7461,295.996,2000793.72,79022.7461,85459.8,85459.8,0.0,-148.0263
23.0,-300.1289,20160410 20:16:40 EST,20160410 20:16:40 EST,20160410 20:16:40 EST,29591.84,,BTCUSD_localbtcRUB,long,,20160410 19:01:30 EST,closed,20160410 19:01:30 EST,29593.94,,,2.0,2.0,,BTCUSD_localbtcRUB,,-4.2,-2.0,USD,78722.6172,295.9289,2000789.52,78722.6172,85455.6,85455.6,0.0,-147.9697
24.0,987.98335,20160410 20:35:24 EST,20160410 20:35:24 EST,20160410 20:35:24 EST,28951.49,,BTCUSD_localbtcRUB,short,,20160410 20:16:40 EST,closed,20160410 20:16:40 EST,29591.84,,,2.0,2.0,,BTCUSD_localbtcRUB,,1280.7,2.0,USD,79710.60055,292.71665,1999508.82,79710.60055,86736.3,86736.3,0.0,-147.9592
25.0,-297.7343,20160410 20:47:51 EST,20160410 20:47:51 EST,20160410 20:47:51 EST,28947.37,,BTCUSD_localbtcRUB,long,,20160410 20:35:24 EST,closed,20160410 20:35:24 EST,28951.49,,,2.0,2.0,,BTCUSD_localbtcRUB,,-8.24000000001,-2.0,USD,79412.86625,289.4943,1999500.58,79412.86625,86728.06,86728.06,0.0,-144.75745
26.0,-1220.57565,20160410 21:05:50 EST,20160410 21:05:50 EST,20160410 21:05:50 EST,29411.76,,BTCUSD_localbtcRUB,short,,20160410 20:47:51 EST,closed,20160410 20:47:51 EST,28947.37,,,2.0,2.0,,BTCUSD_localbtcRUB,,-928.78,2.0,USD,78192.2906,291.79565,2000429.36,78192.2906,85799.28,85799.28,0.0,-144.73685
27.0,17.80065,20160410 21:17:53 EST,20160410 21:17:53 EST,20160410 21:17:53 EST,29568.11,,BTCUSD_localbtcRUB,long,,20160410 21:05:50 EST,closed,20160410 21:05:50 EST,29411.76,,,2.0,2.0,,BTCUSD_localbtcRUB,,312.7,-2.0,USD,78210.09125,294.89935,2000742.06,78210.09125,86111.98,86111.98,0.0,-147.0588
28.0,-331.14955,20160410 22:06:19 EST,20160410 22:06:19 EST,20160410 22:06:19 EST,29585.8,,BTCUSD_localbtcRUB,short,,20160410 21:17:53 EST,closed,20160410 21:17:53 EST,29568.11,,,2.0,2.0,,BTCUSD_localbtcRUB,,-35.38,2.0,USD,77878.9417,295.76955,2000777.44,77878.9417,86076.6,86076.6,0.0,-147.84055
29.0,-1493.43655,20160410 22:18:38 EST,20160410 22:18:38 EST,20160410 22:18:38 EST,28985.51,,BTCUSD_localbtcRUB,long,,20160410 22:06:19 EST,closed,20160410 22:06:19 EST,29585.8,,,2.0,2.0,,BTCUSD_localbtcRUB,,-1200.58,-2.0,USD,76385.50515,292.85655,1999576.86,76385.50515,84876.02,84876.02,0.0,-147.929
30.0,-205.74535,20160410 22:48:26 EST,20160410 22:48:26 EST,20160410 22:48:26 EST,28943.56,,BTCUSD_localbtcRUB,short,,20160410 22:18:38 EST,closed,20160410 22:18:38 EST,28985.51,,,2.0,2.0,,BTCUSD_localbtcRUB,,83.9,2.0,USD,76179.7598,289.64535,1999492.96,76179.7598,84959.92,84959.92,0.0,-144.92755
31.0,-152.19955,20160410 23:02:07 EST,20160410 23:02:07 EST,20160410 23:02:07 EST,29012.35,,BTCUSD_localbtcRUB,long,,20160410 22:48:26 EST,closed,20160410 22:48:26 EST,28943.56,,,2.0,2.0,,BTCUSD_localbtcRUB,,137.58,-2.0,USD,76027.56025,289.77955,1999630.54,76027.56025,85097.5,85097.5,0.0,-144.7178
32.0,-1055.21145,20160410 23:15:55 EST,20160410 23:15:55 EST,20160410 23:15:55 EST,29393.94,,BTCUSD_localbtcRUB,short,,20160410 23:02:07 EST,closed,20160410 23:02:07 EST,29012.35,,,2.0,2.0,,BTCUSD_localbtcRUB,,-763.18,2.0,USD,74972.3488,292.03145,2000393.72,74972.3488,84334.32,84334.32,0.0,-145.06175
33.0,-1164.57735,20160410 23:33:39 EST,20160410 23:33:39 EST,20160410 23:33:39 EST,28957.53,,BTCUSD_localbtcRUB,long,,20160410 23:15:55 EST,closed,20160410 23:15:55 EST,29393.94,,,2.0,2.0,,BTCUSD_localbtcRUB,,-872.82,-2.0,USD,73807.77145,291.75735,1999520.9,73807.77145,83461.5,83461.5,0.0,-146.9697
34.0,-2226.9266,20160411 00:04:53 EST,20160411 00:04:53 EST,20160411 00:04:53 EST,29923.79,,BTCUSD_localbtcRUB,short,,20160410 23:33:39 EST,closed,20160410 23:33:39 EST,28957.53,,,2.0,2.0,,BTCUSD_localbtcRUB,,-1932.52,2.0,USD,71580.84485,294.4066,2001453.42,71580.84485,81528.98,81528.98,0.0,-144.78765
35.0,-1010.9342,20160411 00:18:35 EST,20160411 00:18:35 EST,20160411 00:18:35 EST,29567.05,,BTCUSD_localbtcRUB,long,,20160411 00:04:53 EST,closed,20160411 00:04:53 EST,29923.79,,,2.0,2.0,,BTCUSD_localbtcRUB,,-713.48,-2.0,USD,70569.91065,297.4542,2000739.94,70569.91065,80815.5,80815.5,0.0,-149.61895
36.0,1650.1419,20160411 00:49:16 EST,20160411 00:49:16 EST,20160411 00:49:16 EST,28596.57,,BTCUSD_localbtcRUB,short,,20160411 00:18:35 EST,closed,20160411 00:18:35 EST,29567.05,,,2.0,2.0,,BTCUSD_localbtcRUB,,1940.96,2.0,USD,72220.05255,290.8181,1998798.98,72220.05255,82756.46,82756.46,0.0,-147.83525
37.0,892.93965,20160411 01:03:11 EST,20160411 01:03:11 EST,20160411 01:03:11 EST,29187.5,,BTCUSD_localbtcRUB,long,,20160411 00:49:16 EST,closed,20160411 00:49:16 EST,28596.57,,,2.0,2.0,,BTCUSD_localbtcRUB,,1181.86,-2.0,USD,73112.9922,288.92035,1999980.84,73112.9922,83938.32,83938.32,0.0,-142.98285
38.0,2608.1971,20160411 02:03:00 EST,20160411 02:03:00 EST,20160411 02:03:00 EST,27741.08,,BTCUSD_localbtcRUB,short,,20160411 01:03:11 EST,closed,20160411 01:03:11 EST,29187.5,,,2.0,2.0,,BTCUSD_localbtcRUB,,2892.84,2.0,USD,75721.1893,284.6429,1997088.0,75721.1893,86831.16,86831.16,0.0,-145.9375
39.0,3361.7485,20160411 02:51:27 EST,20160411 02:51:27 EST,20160411 02:51:27 EST,29565.22,,BTCUSD_localbtcRUB,long,,20160411 02:03:00 EST,closed,20160411 02:03:00 EST,27741.08,,,2.0,2.0,,BTCUSD_localbtcRUB,,3648.28,-2.0,USD,79082.9378,286.5315,2000736.28,79082.9378,90479.44,90479.44,0.0,-138.7054
40.0,837.6139,20160411 03:02:13 EST,20160411 03:02:13 EST,20160411 03:02:13 EST,29000.0,,BTCUSD_localbtcRUB,short,,20160411 02:51:27 EST,closed,20160411 02:51:27 EST,29565.22,,,2.0,2.0,,BTCUSD_localbtcRUB,,1130.44,2.0,USD,79920.5517,292.8261,1999605.84,79920.5517,91609.88,91609.88,0.0,-147.8261
41.0,531.4612,20160411 03:34:23 EST,20160411 03:34:23 EST,20160411 03:34:23 EST,29411.76,,BTCUSD_localbtcRUB,long,,20160411 03:02:13 EST,closed,20160411 03:02:13 EST,29000.0,,,2.0,2.0,,BTCUSD_localbtcRUB,,823.52,-2.0,USD,80452.0129,292.0588,2000429.36,80452.0129,92433.4,92433.4,0.0,-145.0
42.0,-50.89105,20160411 04:47:22 EST,20160411 04:47:22 EST,20160411 04:47:22 EST,29290.45,,BTCUSD_localbtcRUB,short,,20160411 03:34:23 EST,closed,20160411 03:34:23 EST,29411.76,,,2.0,2.0,,BTCUSD_localbtcRUB,,242.62,2.0,USD,80401.12185,293.51105,2000186.74,80401.12185,92676.02,92676.02,0.0,-147.0588
43.0,-207.3589,20160411 05:02:18 EST,20160411 05:02:18 EST,20160411 05:02:18 EST,29333.33,,BTCUSD_localbtcRUB,long,,20160411 04:47:22 EST,closed,20160411 04:47:22 EST,29290.45,,,2.0,2.0,,BTCUSD_localbtcRUB,,85.76,-2.0,USD,80193.76295,293.1189,2000272.5,80193.76295,92761.78,92761.78,0.0,-146.45225
44.0,-2237.5818,20160411 06:16:26 EST,20160411 06:16:26 EST,20160411 06:16:26 EST,30303.03,,BTCUSD_localbtcRUB,short,,20160411 05:02:18 EST,closed,20160411 05:02:18 EST,29333.33,,,2.0,2.0,,BTCUSD_localbtcRUB,,-1939.4,2.0,USD,77956.18115,298.1818,2002211.9,77956.18115,90822.38,90822.38,0.0,-146.66665
45.0,-2897.94675,20160411 06:46:23 EST,20160411 06:46:23 EST,20160411 06:46:23 EST,29002.32,,BTCUSD_localbtcRUB,long,,20160411 06:16:26 EST,closed,20160411 06:16:26 EST,30303.03,,,2.0,2.0,,BTCUSD_localbtcRUB,,-2601.42,-2.0,USD,75058.2344,296.52675,1999610.48,75058.2344,88220.96,88220.96,0.0,-151.51515
46.0,-524.14705,20160411 07:05:01 EST,20160411 07:05:01 EST,20160411 07:05:01 EST,29119.09,,BTCUSD_localbtcRUB,short,,20160411 06:46:23 EST,closed,20160411 06:46:23 EST,29002.32,,,2.0,2.0,,BTCUSD_localbtcRUB,,-233.54,2.0,USD,74534.08735,290.60705,1999844.02,74534.08735,87987.42,87987.42,0.0,-145.0116
47.0,-335.2804,20160411 07:24:16 EST,20160411 07:24:16 EST,20160411 07:24:16 EST,29096.99,,BTCUSD_localbtcRUB,long,,20160411 07:05:01 EST,closed,20160411 07:05:01 EST,29119.09,,,2.0,2.0,,BTCUSD_localbtcRUB,,-44.2,-2.0,USD,74198.80695,291.0804,1999799.82,74198.80695,87943.22,87943.22,0.0,-145.59545
48.0,521.07515,20160411 07:31:59 EST,20160411 07:31:59 EST,20160411 07:31:59 EST,28691.98,,BTCUSD_localbtcRUB,short,,20160411 07:24:16 EST,closed,20160411 07:24:16 EST,29096.99,,,2.0,2.0,,BTCUSD_localbtcRUB,,810.02,2.0,USD,74719.8821,288.94485,1998989.8,74719.8821,88753.24,88753.24,0.0,-145.48495
49.0,140.54885,20160411 08:03:14 EST,20160411 08:03:14 EST,20160411 08:03:14 EST,28906.25,,BTCUSD_localbtcRUB,long,,20160411 07:31:59 EST,closed,20160411 07:31:59 EST,28691.98,,,2.0,2.0,,BTCUSD_localbtcRUB,,428.54,-2.0,USD,74860.43095,287.99115,1999418.34,74860.43095,89181.78,89181.78,0.0,-143.4599
50.0,-667.1654,20160411 09:35:19 EST,20160411 09:35:19 EST,20160411 09:35:19 EST,29094.83,,BTCUSD_localbtcRUB,short,,20160411 08:03:14 EST,closed,20160411 08:03:14 EST,28906.25,,,2.0,2.0,,BTCUSD_localbtcRUB,,-377.16,2.0,USD,74193.26555,290.0054,1999795.5,74193.26555,88804.62,88804.62,0.0,-144.53125
51.0,1114.3696,20160411 10:09:37 EST,20160411 10:09:37 EST,20160411 10:09:37 EST,29799.25,,BTCUSD_localbtcRUB,long,,20160411 09:35:19 EST,closed,20160411 09:35:19 EST,29094.83,,,2.0,2.0,,BTCUSD_localbtcRUB,,1408.84,-2.0,USD,75307.63515,294.4704,2001204.34,75307.63515,90213.46,90213.46,0.0,-145.47415
52.0,478.92495,20160411 10:18:29 EST,20160411 10:18:29 EST,20160411 10:18:29 EST,29411.76,,BTCUSD_localbtcRUB,short,,20160411 10:09:37 EST,closed,20160411 10:09:37 EST,29799.25,,,2.0,2.0,,BTCUSD_localbtcRUB,,774.98,2.0,USD,75786.5601,296.05505,2000429.36,75786.5601,90988.44,90988.44,0.0,-148.99625
53.0,-871.1115,20160411 10:49:20 EST,20160411 10:49:20 EST,20160411 10:49:20 EST,29122.54,,BTCUSD_localbtcRUB,long,,20160411 10:18:29 EST,closed,20160411 10:18:29 EST,29411.76,,,2.0,2.0,,BTCUSD_localbtcRUB,,-578.44,-2.0,USD,74915.4486,292.6715,1999850.92,74915.4486,90410.0,90410.0,0.0,-147.0588
54.0,982.57115,20160411 11:02:46 EST,20160411 11:02:46 EST,20160411 11:02:46 EST,28487.23,,BTCUSD_localbtcRUB,short,,20160411 10:49:20 EST,closed,20160411 10:49:20 EST,29122.54,,,2.0,2.0,,BTCUSD_localbtcRUB,,1270.62,2.0,USD,75898.01975,288.04885,1998580.3,75898.01975,91680.62,91680.62,0.0,-145.6127
55.0,589.71575,20160411 11:20:27 EST,20160411 11:20:27 EST,20160411 11:20:27 EST,28925.62,,BTCUSD_localbtcRUB,long,,20160411 11:02:46 EST,closed,20160411 11:02:46 EST,28487.23,,,2.0,2.0,,BTCUSD_localbtcRUB,,876.78,-2.0,USD,76487.7355,287.06425,1999457.08,76487.7355,92557.4,92557.4,0.0,-142.43615
56.0,-1212.2379,20160411 12:18:57 EST,20160411 12:18:57 EST,20160411 12:18:57 EST,29385.96,,BTCUSD_localbtcRUB,short,,20160411 11:20:27 EST,closed,20160411 11:20:27 EST,28925.62,,,2.0,2.0,,BTCUSD_localbtcRUB,,-920.68,2.0,USD,75275.4976,291.5579,2000377.76,75275.4976,91636.72,91636.72,0.0,-144.6281
57.0,-369.92895,20160411 12:32:49 EST,20160411 12:32:49 EST,20160411 12:32:49 EST,29347.83,,BTCUSD_localbtcRUB,long,,20160411 12:18:57 EST,closed,20160411 12:18:57 EST,29385.96,,,2.0,2.0,,BTCUSD_localbtcRUB,,-76.26,-2.0,USD,74905.56865,293.66895,2000301.5,74905.56865,91560.46,91560.46,0.0,-146.9298
58.0,432.9733,20160411 13:01:14 EST,20160411 13:01:14 EST,20160411 13:01:14 EST,28985.51,,BTCUSD_localbtcRUB,short,,20160411 12:32:49 EST,closed,20160411 12:32:49 EST,29347.83,,,2.0,2.0,,BTCUSD_localbtcRUB,,724.64,2.0,USD,75338.54195,291.6667,1999576.86,75338.54195,92285.1,92285.1,0.0,-146.73915
59.0,-1446.37655,20160411 13:19:35 EST,20160411 13:19:35 EST,20160411 13:19:35 EST,28405.8,,BTCUSD_localbtcRUB,long,,20160411 13:01:14 EST,closed,20160411 13:01:14 EST,28985.51,,,2.0,2.0,,BTCUSD_localbtcRUB,,-1159.42,-2.0,USD,73892.1654,286.95655,1998417.44,73892.1654,91125.68,91125.68,0.0,-144.92755
60.0,473.5513,20160411 13:33:45 EST,20160411 13:33:45 EST,20160411 13:33:45 EST,28027.94,,BTCUSD_localbtcRUB,short,,20160411 13:19:35 EST,closed,20160411 13:19:35 EST,28405.8,,,2.0,2.0,,BTCUSD_localbtcRUB,,755.72,2.0,USD,74365.7167,282.1687,1997661.72,74365.7167,91881.4,91881.4,0.0,-142.029
61.0,2257.4803,20160411 13:48:07 EST,20160411 13:48:07 EST,20160411 13:48:07 EST,29300.0,,BTCUSD_localbtcRUB,long,,20160411 13:33:45 EST,closed,20160411 13:33:45 EST,28027.94,,,2.0,2.0,,BTCUSD_localbtcRUB,,2544.12,-2.0,USD,76623.197,286.6397,2000205.84,76623.197,94425.52,94425.52,0.0,-140.1397
62.0,1113.16665,20160411 14:07:28 EST,20160411 14:07:28 EST,20160411 14:07:28 EST,28598.67,,BTCUSD_localbtcRUB,short,,20160411 13:48:07 EST,closed,20160411 13:48:07 EST,29300.0,,,2.0,2.0,,BTCUSD_localbtcRUB,,1402.66,2.0,USD,77736.36365,289.49335,1998803.18,77736.36365,95828.18,95828.18,0.0,-146.5
63.0,1090.62315,20160411 14:21:53 EST,20160411 14:21:53 EST,20160411 14:21:53 EST,29288.7,,BTCUSD_localbtcRUB,long,,20160411 14:07:28 EST,closed,20160411 14:07:28 EST,28598.67,,,2.0,2.0,,BTCUSD_localbtcRUB,,1380.06,-2.0,USD,78826.9868,289.43685,2000183.24,78826.9868,97208.24,97208.24,0.0,-142.99335
64.0,692.02915,20160411 14:49:09 EST,20160411 14:49:09 EST,20160411 14:49:09 EST,28797.47,,BTCUSD_localbtcRUB,short,,20160411 14:21:53 EST,closed,20160411 14:21:53 EST,29288.7,,,2.0,2.0,,BTCUSD_localbtcRUB,,982.46,2.0,USD,79519.01595,290.43085,1999200.78,79519.01595,98190.7,98190.7,0.0,-146.4435
65.0,-94.4597,20160411 15:16:27 EST,20160411 15:16:27 EST,20160411 15:16:27 EST,28894.47,,BTCUSD_localbtcRUB,long,,20160411 14:49:09 EST,closed,20160411 14:49:09 EST,28797.47,,,2.0,2.0,,BTCUSD_localbtcRUB,,194.0,-2.0,USD,79424.55625,288.4597,1999394.78,79424.55625,98384.7,98384.7,0.0,-143.98735
66.0,-98.81055,20160411 16:18:41 EST,20160411 16:18:41 EST,20160411 16:18:41 EST,28799.64,,BTCUSD_localbtcRUB,short,,20160411 15:16:27 EST,closed,20160411 15:16:27 EST,28894.47,,,2.0,2.0,,BTCUSD_localbtcRUB,,189.66,2.0,USD,79325.7457,288.47055,1999205.12,79325.7457,98574.36,98574.36,0.0,-144.47235
67.0,-250.4904,20160411 16:49:06 EST,20160411 16:49:06 EST,20160411 16:49:06 EST,28818.44,,BTCUSD_localbtcRUB,long,,20160411 16:18:41 EST,closed,20160411 16:18:41 EST,28799.64,,,2.0,2.0,,BTCUSD_localbtcRUB,,37.6,-2.0,USD,79075.2553,288.0904,1999242.72,79075.2553,98611.96,98611.96,0.0,-143.9982
68.0,-288.1844,20160411 17:18:57 EST,20160411 17:18:57 EST,20160411 17:18:57 EST,28818.44,,BTCUSD_localbtcRUB,short,,20160411 16:49:06 EST,closed,20160411 16:49:06 EST,28818.44,,,2.0,2.0,,BTCUSD_localbtcRUB,,0.0,2.0,USD,78787.0709,288.1844,1999242.72,78787.0709,98611.96,98611.96,0.0,-144.0922
69.0,1594.0183,20160411 17:33:55 EST,20160411 17:33:55 EST,20160411 17:33:55 EST,29761.9,,BTCUSD_localbtcRUB,long,,20160411 17:18:57 EST,closed,20160411 17:18:57 EST,28818.44,,,2.0,2.0,,BTCUSD_localbtcRUB,,1886.92,-2.0,USD,80381.0892,292.9017,2001129.64,80381.0892,100498.88,100498.88,0.0,-144.0922
70.0,55.4615,20160411 18:49:36 EST,20160411 18:49:36 EST,20160411 18:49:36 EST,29585.8,,BTCUSD_localbtcRUB,short,,20160411 17:33:55 EST,closed,20160411 17:33:55 EST,29761.9,,,2.0,2.0,,BTCUSD_localbtcRUB,,352.2,2.0,USD,80436.5507,296.7385,2000777.44,80436.5507,100851.08,100851.08,0.0,-148.8095
71.0,-183.24025,20160411 19:04:03 EST,20160411 19:04:03 EST,20160411 19:04:03 EST,29642.25,,BTCUSD_localbtcRUB,long,,20160411 18:49:36 EST,closed,20160411 18:49:36 EST,29585.8,,,2.0,2.0,,BTCUSD_localbtcRUB,,112.9,-2.0,USD,80253.31045,296.14025,2000890.34,80253.31045,100963.98,100963.98,0.0,-147.929
72.0,871.3296,20160411 19:37:36 EST,20160411 19:37:36 EST,20160411 19:37:36 EST,29059.83,,BTCUSD_localbtcRUB,short,,20160411 19:04:03 EST,closed,20160411 19:04:03 EST,29642.25,,,2.0,2.0,,BTCUSD_localbtcRUB,,1164.84,2.0,USD,81124.64005,293.5104,1999725.5,81124.64005,102128.82,102128.82,0.0,-148.21125
73.0,575.5908,20160411 19:47:28 EST,20160411 19:47:28 EST,20160411 19:47:28 EST,29494.01,,BTCUSD_localbtcRUB,long,,20160411 19:37:36 EST,closed,20160411 19:37:36 EST,29059.83,,,2.0,2.0,,BTCUSD_localbtcRUB,,868.36,-2.0,USD,81700.23085,292.7692,2000593.86,81700.23085,102997.18,102997.18,0.0,-145.29915
74.0,724.6024,20160411 20:34:25 EST,20160411 20:34:25 EST,20160411 20:34:25 EST,28985.51,,BTCUSD_localbtcRUB,short,,20160411 19:47:28 EST,closed,20160411 19:47:28 EST,29494.01,,,2.0,2.0,,BTCUSD_localbtcRUB,,1017.0,2.0,USD,82424.83325,292.3976,1999576.86,82424.83325,104014.18,104014.18,0.0,-147.47005
75.0,931.54375,20160411 23:31:33 EST,20160411 23:31:33 EST,20160411 23:31:33 EST,29597.74,,BTCUSD_localbtcRUB,long,,20160411 20:34:25 EST,closed,20160411 20:34:25 EST,28985.51,,,2.0,2.0,,BTCUSD_localbtcRUB,,1224.46,-2.0,USD,83356.377,292.91625,2000801.32,83356.377,105238.64,105238.64,0.0,-144.92755
76.0,4104.4763,20160412 00:16:25 EST,20160412 00:16:25 EST,20160412 00:16:25 EST,27403.0,,BTCUSD_localbtcRUB,short,,20160411 23:31:33 EST,closed,20160411 23:31:33 EST,29597.74,,,2.0,2.0,,BTCUSD_localbtcRUB,,4389.48,2.0,USD,87460.8533,285.0037,1996411.84,87460.8533,109628.12,109628.12,0.0,-147.9887
77.0,3478.8842,20160412 00:47:22 EST,20160412 00:47:22 EST,20160412 00:47:22 EST,29284.16,,BTCUSD_localbtcRUB,long,,20160412 00:16:25 EST,closed,20160412 00:16:25 EST,27403.0,,,2.0,2.0,,BTCUSD_localbtcRUB,,3762.32,-2.0,USD,90939.7375,283.4358,2000174.16,90939.7375,113390.44,113390.44,0.0,-137.015
78.0,-709.21995,20160412 01:33:08 EST,20160412 01:33:08 EST,20160412 01:33:08 EST,29491.83,,BTCUSD_localbtcRUB,short,,20160412 00:47:22 EST,closed,20160412 00:47:22 EST,29284.16,,,2.0,2.0,,BTCUSD_localbtcRUB,,-415.34,2.0,USD,90230.51755,293.87995,2000589.5,90230.51755,112975.1,112975.1,0.0,-146.4208
79.0,-165.6024,20160412 02:19:21 EST,20160412 02:19:21 EST,20160412 02:19:21 EST,29556.65,,BTCUSD_localbtcRUB,long,,20160412 01:33:08 EST,closed,20160412 01:33:08 EST,29491.83,,,2.0,2.0,,BTCUSD_localbtcRUB,,129.64,-2.0,USD,90064.91515,295.2424,2000719.14,90064.91515,113104.74,113104.74,0.0,-147.45915
80.0,-156.27915,20160412 02:35:01 EST,20160412 02:35:01 EST,20160412 02:35:01 EST,29487.18,,BTCUSD_localbtcRUB,short,,20160412 02:19:21 EST,closed,20160412 02:19:21 EST,29556.65,,,2.0,2.0,,BTCUSD_localbtcRUB,,138.94,2.0,USD,89908.636,295.21915,2000580.2,89908.636,113243.68,113243.68,0.0,-147.78325
81.0,-1486.2459,20160412 02:50:43 EST,20160412 02:50:43 EST,20160412 02:50:43 EST,28890.0,,BTCUSD_localbtcRUB,long,,20160412 02:35:01 EST,closed,20160412 02:35:01 EST,29487.18,,,2.0,2.0,,BTCUSD_localbtcRUB,,-1194.36,-2.0,USD,88422.3901,291.8859,1999385.84,88422.3901,112049.32,112049.32,0.0,-147.4359
82.0,-280.53915,20160412 03:16:34 EST,20160412 03:16:34 EST,20160412 03:16:34 EST,28885.83,,BTCUSD_localbtcRUB,short,,20160412 02:50:43 EST,closed,20160412 02:50:43 EST,28890.0,,,2.0,2.0,,BTCUSD_localbtcRUB,,8.34,2.0,USD,88141.85095,288.87915,1999377.5,88141.85095,112057.66,112057.66,0.0,-144.45
83.0,515.3661,20160412 04:20:09 EST,20160412 04:20:09 EST,20160412 04:20:09 EST,29288.95,,BTCUSD_localbtcRUB,long,,20160412 03:16:34 EST,closed,20160412 03:16:34 EST,28885.83,,,2.0,2.0,,BTCUSD_localbtcRUB,,806.24,-2.0,USD,88657.21705,290.8739,2000183.74,88657.21705,112863.9,112863.9,0.0,-144.42915
84.0,3545.06145,20160412 04:31:10 EST,20160412 04:31:10 EST,20160412 04:31:10 EST,27374.76,,BTCUSD_localbtcRUB,short,,20160412 04:20:09 EST,closed,20160412 04:20:09 EST,29288.95,,,2.0,2.0,,BTCUSD_localbtcRUB,,3828.38,2.0,USD,92202.2785,283.31855,1996355.36,92202.2785,116692.28,116692.28,0.0,-146.44475
85.0,3568.24335,20160412 04:46:42 EST,20160412 04:46:42 EST,20160412 04:46:42 EST,29300.57,,BTCUSD_localbtcRUB,long,,20160412 04:31:10 EST,closed,20160412 04:31:10 EST,27374.76,,,2.0,2.0,,BTCUSD_localbtcRUB,,3851.62,-2.0,USD,95770.52185,283.37665,2000206.98,95770.52185,120543.9,120543.9,0.0,-136.8738
86.0,315.0707,20160412 05:51:10 EST,20160412 05:51:10 EST,20160412 05:51:10 EST,28997.29,,BTCUSD_localbtcRUB,short,,20160412 04:46:42 EST,closed,20160412 04:46:42 EST,29300.57,,,2.0,2.0,,BTCUSD_localbtcRUB,,606.56,2.0,USD,96085.59255,291.4893,1999600.42,96085.59255,121150.46,121150.46,0.0,-146.50285
87.0,450.75065,20160412 06:02:05 EST,20160412 06:02:05 EST,20160412 06:02:05 EST,29368.58,,BTCUSD_localbtcRUB,long,,20160412 05:51:10 EST,closed,20160412 05:51:10 EST,28997.29,,,2.0,2.0,,BTCUSD_localbtcRUB,,742.58,-2.0,USD,96536.3432,291.82935,2000343.0,96536.3432,121893.04,121893.04,0.0,-144.98645
88.0,-119.63175,20160412 06:34:28 EST,20160412 06:34:28 EST,20160412 06:34:28 EST,29281.77,,BTCUSD_localbtcRUB,short,,20160412 06:02:05 EST,closed,20160412 06:02:05 EST,29368.58,,,2.0,2.0,,BTCUSD_localbtcRUB,,173.62,2.0,USD,96416.71145,293.25175,2000169.38,96416.71145,122066.66,122066.66,0.0,-146.8429
89.0,-496.2279,20160412 06:51:07 EST,20160412 06:51:07 EST,20160412 06:51:07 EST,29179.81,,BTCUSD_localbtcRUB,long,,20160412 06:34:28 EST,closed,20160412 06:34:28 EST,29281.77,,,2.0,2.0,,BTCUSD_localbtcRUB,,-203.92,-2.0,USD,95920.48355,292.3079,1999965.46,95920.48355,121862.74,121862.74,0.0,-146.40885
90.0,1054.4391,20160412 07:20:03 EST,20160412 07:20:03 EST,20160412 07:20:03 EST,28508.37,,BTCUSD_localbtcRUB,short,,20160412 06:51:07 EST,closed,20160412 06:51:07 EST,29179.81,,,2.0,2.0,,BTCUSD_localbtcRUB,,1342.88,2.0,USD,96974.92265,288.4409,1998622.58,96974.92265,123205.62,123205.62,0.0,-145.89905
91.0,562.2327,20160412 08:04:55 EST,20160412 08:04:55 EST,20160412 08:04:55 EST,28933.09,,BTCUSD_localbtcRUB,long,,20160412 07:20:03 EST,closed,20160412 07:20:03 EST,28508.37,,,2.0,2.0,,BTCUSD_localbtcRUB,,849.44,-2.0,USD,97537.15535,287.2073,1999472.02,97537.15535,124055.06,124055.06,0.0,-142.54185
92.0,2267.405,20160412 08:21:37 EST,20160412 08:21:37 EST,20160412 08:21:37 EST,27657.91,,BTCUSD_localbtcRUB,short,,20160412 08:04:55 EST,closed,20160412 08:04:55 EST,28933.09,,,2.0,2.0,,BTCUSD_localbtcRUB,,2550.36,2.0,USD,99804.56035,282.955,1996921.66,99804.56035,126605.42,126605.42,0.0,-144.66545
93.0,2337.5492,20160412 08:32:50 EST,20160412 08:32:50 EST,20160412 08:32:50 EST,28968.25,,BTCUSD_localbtcRUB,long,,20160412 08:21:37 EST,closed,20160412 08:21:37 EST,27657.91,,,2.0,2.0,,BTCUSD_localbtcRUB,,2620.68,-2.0,USD,102142.10955,283.1308,1999542.34,102142.10955,129226.1,129226.1,0.0,-138.28955
94.0,-493.2301,20160412 09:01:24 EST,20160412 09:01:24 EST,20160412 09:01:24 EST,29069.77,,BTCUSD_localbtcRUB,short,,20160412 08:32:50 EST,closed,20160412 08:32:50 EST,28968.25,,,2.0,2.0,,BTCUSD_localbtcRUB,,-203.04,2.0,USD,101648.87945,290.1901,1999745.38,101648.87945,129023.06,129023.06,0.0,-144.84125
95.0,-132.9331,20160412 09:18:46 EST,20160412 09:18:46 EST,20160412 09:18:46 EST,29148.85,,BTCUSD_localbtcRUB,long,,20160412 09:01:24 EST,closed,20160412 09:01:24 EST,29069.77,,,2.0,2.0,,BTCUSD_localbtcRUB,,158.16,-2.0,USD,101515.94635,291.0931,1999903.54,101515.94635,129181.22,129181.22,0.0,-145.34885
96.0,-287.3582,20160412 09:36:21 EST,20160412 09:36:21 EST,20160412 09:36:21 EST,29146.79,,BTCUSD_localbtcRUB,short,,20160412 09:18:46 EST,closed,20160412 09:18:46 EST,29148.85,,,2.0,2.0,,BTCUSD_localbtcRUB,,4.12,2.0,USD,101228.58815,291.4782,1999899.42,101228.58815,129185.34,129185.34,0.0,-145.74425
97.0,-584.31395,20160412 09:48:25 EST,20160412 09:48:25 EST,20160412 09:48:25 EST,29000.0,,BTCUSD_localbtcRUB,long,,20160412 09:36:21 EST,closed,20160412 09:36:21 EST,29146.79,,,2.0,2.0,,BTCUSD_localbtcRUB,,-293.58,-2.0,USD,100644.2742,290.73395,1999605.84,100644.2742,128891.76,128891.76,0.0,-145.73395
98.0,381.25395,20160412 10:06:10 EST,20160412 10:06:10 EST,20160412 10:06:10 EST,28665.21,,BTCUSD_localbtcRUB,short,,20160412 09:48:25 EST,closed,20160412 09:48:25 EST,29000.0,,,2.0,2.0,,BTCUSD_localbtcRUB,,669.58,2.0,USD,101025.52815,288.32605,1998936.26,101025.52815,129561.34,129561.34,0.0,-145.0
99.0,1011.59415,20160412 10:48:42 EST,20160412 10:48:42 EST,20160412 10:48:42 EST,29315.96,,BTCUSD_localbtcRUB,long,,20160412 10:06:10 EST,closed,20160412 10:06:10 EST,28665.21,,,2.0,2.0,,BTCUSD_localbtcRUB,,1301.5,-2.0,USD,102037.1223,289.90585,2000237.76,102037.1223,130862.84,130862.84,0.0,-143.32605
100.0,369.39265,20160412 11:06:45 EST,20160412 11:06:45 EST,20160412 11:06:45 EST,28985.51,,BTCUSD_localbtcRUB,short,,20160412 10:48:42 EST,closed,20160412 10:48:42 EST,29315.96,,,2.0,2.0,,BTCUSD_localbtcRUB,,660.9,2.0,USD,102406.51495,291.50735,1999576.86,102406.51495,131523.74,131523.74,0.0,-146.5798
101.0,-1590.9542,20160412 11:19:13 EST,20160412 11:19:13 EST,20160412 11:19:13 EST,28333.33,,BTCUSD_localbtcRUB,long,,20160412 11:06:45 EST,closed,20160412 11:06:45 EST,28985.51,,,2.0,2.0,,BTCUSD_localbtcRUB,,-1304.36,-2.0,USD,100815.56075,286.5942,1998272.5,100815.56075,130219.38,130219.38,0.0,-144.92755
102.0,1316.1755,20160412 13:36:03 EST,20160412 13:36:03 EST,20160412 13:36:03 EST,27535.57,,BTCUSD_localbtcRUB,short,,20160412 11:19:13 EST,closed,20160412 11:19:13 EST,28333.33,,,2.0,2.0,,BTCUSD_localbtcRUB,,1595.52,2.0,USD,102131.73625,279.3445,1996676.98,102131.73625,131814.9,131814.9,0.0,-141.66665
103.0,3261.28055,20160412 13:48:56 EST,20160412 13:48:56 EST,20160412 13:48:56 EST,29308.32,,BTCUSD_localbtcRUB,long,,20160412 13:36:03 EST,closed,20160412 13:36:03 EST,27535.57,,,2.0,2.0,,BTCUSD_localbtcRUB,,3545.5,-2.0,USD,105393.0168,284.21945,2000222.48,105393.0168,135360.4,135360.4,0.0,-137.67785
104.0,345.1484,20160412 14:20:28 EST,20160412 14:20:28 EST,20160412 14:20:28 EST,28990.0,,BTCUSD_localbtcRUB,short,,20160412 13:48:56 EST,closed,20160412 13:48:56 EST,29308.32,,,2.0,2.0,,BTCUSD_localbtcRUB,,636.64,2.0,USD,105738.1652,291.4916,1999585.84,105738.1652,135997.04,135997.04,0.0,-146.5416
105.0,285.63755,20160412 14:33:04 EST,20160412 14:33:04 EST,20160412 14:33:04 EST,29278.49,,BTCUSD_localbtcRUB,long,,20160412 14:20:28 EST,closed,20160412 14:20:28 EST,28990.0,,,2.0,2.0,,BTCUSD_localbtcRUB,,576.98,-2.0,USD,106023.80275,291.34245,2000162.82,106023.80275,136574.02,136574.02,0.0,-144.95
106.0,-292.84505,20160412 14:52:09 EST,20160412 14:52:09 EST,20160412 14:52:09 EST,29278.52,,BTCUSD_localbtcRUB,short,,20160412 14:33:04 EST,closed,20160412 14:33:04 EST,29278.49,,,2.0,2.0,,BTCUSD_localbtcRUB,,-0.0599999999977,2.0,USD,105730.9577,292.78505,2000162.88,105730.9577,136573.96,136573.96,0.0,-146.39245
107.0,-6119.32235,20160412 15:05:03 EST,20160412 15:05:03 EST,20160412 15:05:03 EST,26357.95,,BTCUSD_localbtcRUB,long,,20160412 14:52:09 EST,closed,20160412 14:52:09 EST,29278.52,,,2.0,2.0,,BTCUSD_localbtcRUB,,-5841.14,-2.0,USD,99611.63535,278.18235,1994321.74,99611.63535,130732.82,130732.82,0.0,-146.3926
108.0,-5411.75785,20160412 15:17:13 EST,20160412 15:17:13 EST,20160412 15:17:13 EST,28925.62,,BTCUSD_localbtcRUB,short,,20160412 15:05:03 EST,closed,20160412 15:05:03 EST,26357.95,,,2.0,2.0,,BTCUSD_localbtcRUB,,-5135.34,2.0,USD,94199.8775,276.41785,1999457.08,94199.8775,125597.48,125597.48,0.0,-131.78975
109.0,-531.18985,20160412 15:35:21 EST,20160412 15:35:21 EST,20160412 15:35:21 EST,28804.35,,BTCUSD_localbtcRUB,long,,20160412 15:17:13 EST,closed,20160412 15:17:13 EST,28925.62,,,2.0,2.0,,BTCUSD_localbtcRUB,,-242.54,-2.0,USD,93668.68765,288.64985,1999214.54,93668.68765,125354.94,125354.94,0.0,-144.6281
110.0,-870.4559,20160412 15:48:28 EST,20160412 15:48:28 EST,20160412 15:48:28 EST,29094.83,,BTCUSD_localbtcRUB,short,,20160412 15:35:21 EST,closed,20160412 15:35:21 EST,28804.35,,,2.0,2.0,,BTCUSD_localbtcRUB,,-580.96,2.0,USD,92798.23175,289.4959,1999795.5,92798.23175,124773.98,124773.98,0.0,-144.02175
111.0,-484.3835,20160412 16:35:17 EST,20160412 16:35:17 EST,20160412 16:35:17 EST,28997.87,,BTCUSD_localbtcRUB,long,,20160412 15:48:28 EST,closed,20160412 15:48:28 EST,29094.83,,,2.0,2.0,,BTCUSD_localbtcRUB,,-193.92,-2.0,USD,92313.84825,290.4635,1999601.58,92313.84825,124580.06,124580.06,0.0,-145.47415
112.0,621.4141,20160412 16:48:44 EST,20160412 16:48:44 EST,20160412 16:48:44 EST,28543.31,,BTCUSD_localbtcRUB,short,,20160412 16:35:17 EST,closed,20160412 16:35:17 EST,28997.87,,,2.0,2.0,,BTCUSD_localbtcRUB,,909.12,2.0,USD,92935.26235,287.7059,1998692.46,92935.26235,125489.18,125489.18,0.0,-144.98935
113.0,636.67585,20160412 17:32:32 EST,20160412 17:32:32 EST,20160412 17:32:32 EST,29005.52,,BTCUSD_localbtcRUB,long,,20160412 16:48:44 EST,closed,20160412 16:48:44 EST,28543.31,,,2.0,2.0,,BTCUSD_localbtcRUB,,924.42,-2.0,USD,93571.9382,287.74415,1999616.88,93571.9382,126413.6,126413.6,0.0,-142.71655
114.0,-313.3533,20160412 17:51:36 EST,20160412 17:51:36 EST,20160412 17:51:36 EST,29017.14,,BTCUSD_localbtcRUB,short,,20160412 17:32:32 EST,closed,20160412 17:32:32 EST,29005.52,,,2.0,2.0,,BTCUSD_localbtcRUB,,-23.24,2.0,USD,93258.5849,290.1133,1999640.12,93258.5849,126390.36,126390.36,0.0,-145.0276
115.0,-344.3157,20160412 18:04:33 EST,20160412 18:04:33 EST,20160412 18:04:33 EST,28990.0,,BTCUSD_localbtcRUB,long,,20160412 17:51:36 EST,closed,20160412 17:51:36 EST,29017.14,,,2.0,2.0,,BTCUSD_localbtcRUB,,-54.28,-2.0,USD,92914.2692,290.0357,1999585.84,92914.2692,126336.08,126336.08,0.0,-145.0857
116.0,-1340.29945,20160412 18:35:10 EST,20160412 18:35:10 EST,20160412 18:35:10 EST,29513.89,,BTCUSD_localbtcRUB,short,,20160412 18:04:33 EST,closed,20160412 18:04:33 EST,28990.0,,,2.0,2.0,,BTCUSD_localbtcRUB,,-1047.78,2.0,USD,91573.96975,292.51945,2000633.62,91573.96975,125288.3,125288.3,0.0,-144.95
117.0,-2488.1626,20160413 07:39:00 EST,20160413 07:39:00 EST,20160413 07:39:00 EST,28414.63,,BTCUSD_localbtcRUB,long,,20160412 18:35:10 EST,closed,20160412 18:35:10 EST,29513.89,,,2.0,2.0,,BTCUSD_localbtcRUB,,-2198.52,-2.0,USD,89085.80715,289.6426,1998435.1,89085.80715,123089.78,123089.78,0.0,-147.56945
118.0,2850.8717,20160413 07:48:49 EST,20160413 07:48:49 EST,20160413 07:48:49 EST,26851.03,,BTCUSD_localbtcRUB,short,,20160413 07:39:00 EST,closed,20160413 07:39:00 EST,28414.63,,,2.0,2.0,,BTCUSD_localbtcRUB,,3127.2,2.0,USD,91936.67885,276.3283,1995307.9,91936.67885,126216.98,126216.98,0.0,-142.07315
119.0,3607.256,20160413 08:25:10 EST,20160413 08:25:10 EST,20160413 08:25:10 EST,28793.77,,BTCUSD_localbtcRUB,long,,20160413 07:48:49 EST,closed,20160413 07:48:49 EST,26851.03,,,2.0,2.0,,BTCUSD_localbtcRUB,,3885.48,-2.0,USD,95543.93485,278.224,1999193.38,95543.93485,130102.46,130102.46,0.0,-134.25515
120.0,2596.79615,20160413 09:37:36 EST,20160413 09:37:36 EST,20160413 09:37:36 EST,27355.0,,BTCUSD_localbtcRUB,short,,20160413 08:25:10 EST,closed,20160413 08:25:10 EST,28793.77,,,2.0,2.0,,BTCUSD_localbtcRUB,,2877.54,2.0,USD,98140.731,280.74385,1996315.84,98140.731,132980.0,132980.0,0.0,-143.96885
121.0,2219.50175,20160413 09:47:03 EST,20160413 09:47:03 EST,20160413 09:47:03 EST,28604.65,,BTCUSD_localbtcRUB,long,,20160413 09:37:36 EST,closed,20160413 09:37:36 EST,27355.0,,,2.0,2.0,,BTCUSD_localbtcRUB,,2499.3,-2.0,USD,100360.23275,279.79825,1998815.14,100360.23275,135479.3,135479.3,0.0,-136.775
122.0,-1085.6806,20160413 10:22:00 EST,20160413 10:22:00 EST,20160413 10:22:00 EST,29003.47,,BTCUSD_localbtcRUB,short,,20160413 09:47:03 EST,closed,20160413 09:47:03 EST,28604.65,,,2.0,2.0,,BTCUSD_localbtcRUB,,-797.64,2.0,USD,99274.55215,288.0406,1999612.78,99274.55215,134681.66,134681.66,0.0,-143.02325
123.0,-143.50195,20160413 10:36:27 EST,20160413 10:36:27 EST,20160413 10:36:27 EST,29076.92,,BTCUSD_localbtcRUB,long,,20160413 10:22:00 EST,closed,20160413 10:22:00 EST,29003.47,,,2.0,2.0,,BTCUSD_localbtcRUB,,146.9,-2.0,USD,99131.0502,290.40195,1999759.68,99131.0502,134828.56,134828.56,0.0,-145.01735
124.0,-79.42215,20160413 10:53:06 EST,20160413 10:53:06 EST,20160413 10:53:06 EST,28971.51,,BTCUSD_localbtcRUB,short,,20160413 10:36:27 EST,closed,20160413 10:36:27 EST,29076.92,,,2.0,2.0,,BTCUSD_localbtcRUB,,210.82,2.0,USD,99051.62805,290.24215,1999548.86,99051.62805,135039.38,135039.38,0.0,-145.3846
125.0,-337.8744,20160413 11:02:20 EST,20160413 11:02:20 EST,20160413 11:02:20 EST,28947.37,,BTCUSD_localbtcRUB,long,,20160413 10:53:06 EST,closed,20160413 10:53:06 EST,28971.51,,,2.0,2.0,,BTCUSD_localbtcRUB,,-48.28,-2.0,USD,98713.75365,289.5944,1999500.58,98713.75365,134991.1,134991.1,0.0,-144.85755
126.0,464.286,20160413 12:54:13 EST,20160413 12:54:13 EST,20160413 12:54:13 EST,28571.43,,BTCUSD_localbtcRUB,short,,20160413 11:02:20 EST,closed,20160413 11:02:20 EST,28947.37,,,2.0,2.0,,BTCUSD_localbtcRUB,,751.88,2.0,USD,99178.03965,287.594,1998748.7,99178.03965,135742.98,135742.98,0.0,-144.73685
127.0,-285.7143,20160413 13:03:26 EST,20160413 13:03:26 EST,20160413 13:03:26 EST,28571.43,,BTCUSD_localbtcRUB,long,,20160413 12:54:13 EST,closed,20160413 12:54:13 EST,28571.43,,,2.0,2.0,,BTCUSD_localbtcRUB,,0.0,-2.0,USD,98892.32535,285.7143,1998748.7,98892.32535,135742.98,135742.98,0.0,-142.85715
128.0,101.75195,20160413 14:40:08 EST,20160413 14:40:08 EST,20160413 14:40:08 EST,28378.18,,BTCUSD_localbtcRUB,short,,20160413 13:03:26 EST,closed,20160413 13:03:26 EST,28571.43,,,2.0,2.0,,BTCUSD_localbtcRUB,,386.5,2.0,USD,98994.0773,284.74805,1998362.2,98994.0773,136129.48,136129.48,0.0,-142.85715
129.0,457.9991,20160413 14:52:51 EST,20160413 14:52:51 EST,20160413 14:52:51 EST,28750.0,,BTCUSD_localbtcRUB,long,,20160413 14:40:08 EST,closed,20160413 14:40:08 EST,28378.18,,,2.0,2.0,,BTCUSD_localbtcRUB,,743.64,-2.0,USD,99452.0764,285.6409,1999105.84,99452.0764,136873.12,136873.12,0.0,-141.8909
130.0,-379.34905,20160413 15:03:05 EST,20160413 15:03:05 EST,20160413 15:03:05 EST,28795.81,,BTCUSD_localbtcRUB,short,,20160413 14:52:51 EST,closed,20160413 14:52:51 EST,28750.0,,,2.0,2.0,,BTCUSD_localbtcRUB,,-91.62,2.0,USD,99072.72735,287.72905,1999197.46,99072.72735,136781.5,136781.5,0.0,-143.75
131.0,-76.6477,20160413 15:22:19 EST,20160413 15:22:19 EST,20160413 15:22:19 EST,28901.73,,BTCUSD_localbtcRUB,long,,20160413 15:03:05 EST,closed,20160413 15:03:05 EST,28795.81,,,2.0,2.0,,BTCUSD_localbtcRUB,,211.84,-2.0,USD,98996.07965,288.4877,1999409.3,98996.07965,136993.34,136993.34,0.0,-143.97905
132.0,-970.01555,20160413 17:34:50 EST,20160413 17:34:50 EST,20160413 17:34:50 EST,29241.38,,BTCUSD_localbtcRUB,short,,20160413 15:22:19 EST,closed,20160413 15:22:19 EST,28901.73,,,2.0,2.0,,BTCUSD_localbtcRUB,,-679.3,2.0,USD,98026.0641,290.71555,2000088.6,98026.0641,136314.04,136314.04,0.0,-144.50865
133.0,-1604.8844,20160413 17:54:44 EST,20160413 17:54:44 EST,20160413 17:54:44 EST,28583.5,,BTCUSD_localbtcRUB,long,,20160413 17:34:50 EST,closed,20160413 17:34:50 EST,29241.38,,,2.0,2.0,,BTCUSD_localbtcRUB,,-1315.76,-2.0,USD,96421.1797,289.1244,1998772.84,96421.1797,134998.28,134998.28,0.0,-146.2069
134.0,-632.27895,20160413 19:03:10 EST,20160413 19:03:10 EST,20160413 19:03:10 EST,28756.29,,BTCUSD_localbtcRUB,short,,20160413 17:54:44 EST,closed,20160413 17:54:44 EST,28583.5,,,2.0,2.0,,BTCUSD_localbtcRUB,,-345.58,2.0,USD,95788.90075,286.69895,1999118.42,95788.90075,134652.7,134652.7,0.0,-142.9175
135.0,1649.5422,20160413 19:35:04 EST,20160413 19:35:04 EST,20160413 19:35:04 EST,29727.27,,BTCUSD_localbtcRUB,long,,20160413 19:03:10 EST,closed,20160413 19:03:10 EST,28756.29,,,2.0,2.0,,BTCUSD_localbtcRUB,,1941.96,-2.0,USD,97438.44295,292.4178,2001060.38,97438.44295,136594.66,136594.66,0.0,-143.78145
136.0,1622.37445,20160413 20:17:54 EST,20160413 20:17:54 EST,20160413 20:17:54 EST,28769.84,,BTCUSD_localbtcRUB,short,,20160413 19:35:04 EST,closed,20160413 19:35:04 EST,29727.27,,,2.0,2.0,,BTCUSD_localbtcRUB,,1914.86,2.0,USD,99060.8174,292.48555,1999145.52,99060.8174,138509.52,138509.52,0.0,-148.63635
137.0,1924.3177,20160413 20:39:11 EST,20160413 20:39:11 EST,20160413 20:39:11 EST,29878.62,,BTCUSD_localbtcRUB,long,,20160413 20:17:54 EST,closed,20160413 20:17:54 EST,28769.84,,,2.0,2.0,,BTCUSD_localbtcRUB,,2217.56,-2.0,USD,100985.1351,293.2423,2001363.08,100985.1351,140727.08,140727.08,0.0,-143.8492
138.0,46.7555,20160413 20:50:25 EST,20160413 20:50:25 EST,20160413 20:50:25 EST,29706.28,,BTCUSD_localbtcRUB,short,,20160413 20:39:11 EST,closed,20160413 20:39:11 EST,29878.62,,,2.0,2.0,,BTCUSD_localbtcRUB,,344.68,2.0,USD,101031.8906,297.9245,2001018.4,101031.8906,141071.76,141071.76,0.0,-149.3931
139.0,-2531.4628,20160413 21:18:28 EST,20160413 21:18:28 EST,20160413 21:18:28 EST,28586.28,,BTCUSD_localbtcRUB,long,,20160413 20:50:25 EST,closed,20160413 20:50:25 EST,29706.28,,,2.0,2.0,,BTCUSD_localbtcRUB,,-2240.0,-2.0,USD,98500.4278,291.4628,1998778.4,98500.4278,138831.76,138831.76,0.0,-148.5314
140.0,2693.58725,20160413 22:35:09 EST,20160413 22:35:09 EST,20160413 22:35:09 EST,27100.27,,BTCUSD_localbtcRUB,short,,20160413 21:18:28 EST,closed,20160413 21:18:28 EST,28586.28,,,2.0,2.0,,BTCUSD_localbtcRUB,,2972.02,2.0,USD,101194.01505,278.43275,1995806.38,101194.01505,141803.78,141803.78,0.0,-142.9314
141.0,4921.3838,20160413 23:52:53 EST,20160413 23:52:53 EST,20160413 23:52:53 EST,29702.97,,BTCUSD_localbtcRUB,long,,20160413 22:35:09 EST,closed,20160413 22:35:09 EST,27100.27,,,2.0,2.0,,BTCUSD_localbtcRUB,,5205.4,-2.0,USD,106115.39885,284.0162,2001011.78,106115.39885,147009.18,147009.18,0.0,-135.50135
142.0,-11.9989,20160414 00:03:48 EST,20160414 00:03:48 EST,20160414 00:03:48 EST,29560.81,,BTCUSD_localbtcRUB,short,,20160413 23:52:53 EST,closed,20160413 23:52:53 EST,29702.97,,,2.0,2.0,,BTCUSD_localbtcRUB,,284.32,2.0,USD,106103.39995,296.3189,2000727.46,106103.39995,147293.5,147293.5,0.0,-148.51485
143.0,-1886.87995,20160414 00:25:29 EST,20160414 00:25:29 EST,20160414 00:25:29 EST,28763.18,,BTCUSD_localbtcRUB,long,,20160414 00:03:48 EST,closed,20160414 00:03:48 EST,29560.81,,,2.0,2.0,,BTCUSD_localbtcRUB,,-1595.26,-2.0,USD,104216.52,291.61995,1999132.2,104216.52,145698.24,145698.24,0.0,-147.80405
144.0,-261.2059,20160414 00:36:17 EST,20160414 00:36:17 EST,20160414 00:36:17 EST,28750.0,,BTCUSD_localbtcRUB,short,,20160414 00:25:29 EST,closed,20160414 00:25:29 EST,28763.18,,,2.0,2.0,,BTCUSD_localbtcRUB,,26.36,2.0,USD,103955.3141,287.5659,1999105.84,103955.3141,145724.6,145724.6,0.0,-143.8159
145.0,-259.4902,20160414 00:58:09 EST,20160414 00:58:09 EST,20160414 00:58:09 EST,28764.04,,BTCUSD_localbtcRUB,long,,20160414 00:36:17 EST,closed,20160414 00:36:17 EST,28750.0,,,2.0,2.0,,BTCUSD_localbtcRUB,,28.08,-2.0,USD,103695.8239,287.5702,1999133.92,103695.8239,145752.68,145752.68,0.0,-143.75
146.0,-1913.7756,20160414 01:08:48 EST,20160414 01:08:48 EST,20160414 01:08:48 EST,29575.08,,BTCUSD_localbtcRUB,short,,20160414 00:58:09 EST,closed,20160414 00:58:09 EST,28764.04,,,2.0,2.0,,BTCUSD_localbtcRUB,,-1622.08,2.0,USD,101782.0483,291.6956,2000756.0,101782.0483,144130.6,144130.6,0.0,-143.8202
147.0,-274.3644,20160414 01:31:52 EST,20160414 01:31:52 EST,20160414 01:31:52 EST,29585.8,,BTCUSD_localbtcRUB,long,,20160414 01:08:48 EST,closed,20160414 01:08:48 EST,29575.08,,,2.0,2.0,,BTCUSD_localbtcRUB,,21.44,-2.0,USD,101507.6839,295.8044,2000777.44,101507.6839,144152.04,144152.04,0.0,-147.8754
148.0,-272.98095,20160414 01:53:58 EST,20160414 01:53:58 EST,20160414 01:53:58 EST,29574.39,,BTCUSD_localbtcRUB,short,,20160414 01:31:52 EST,closed,20160414 01:31:52 EST,29585.8,,,2.0,2.0,,BTCUSD_localbtcRUB,,22.82,2.0,USD,101234.70295,295.80095,2000754.62,101234.70295,144174.86,144174.86,0.0,-147.929
149.0,-1252.4661,20160414 02:27:58 EST,20160414 02:27:58 EST,20160414 02:27:58 EST,29094.83,,BTCUSD_localbtcRUB,long,,20160414 01:53:58 EST,closed,20160414 01:53:58 EST,29574.39,,,2.0,2.0,,BTCUSD_localbtcRUB,,-959.12,-2.0,USD,99982.23685,293.3461,1999795.5,99982.23685,143215.74,143215.74,0.0,-147.87195
150.0,850.95935,20160414 03:36:11 EST,20160414 03:36:11 EST,20160414 03:36:11 EST,28525.3,,BTCUSD_localbtcRUB,short,,20160414 02:27:58 EST,closed,20160414 02:27:58 EST,29094.83,,,2.0,2.0,,BTCUSD_localbtcRUB,,1139.06,2.0,USD,100833.1962,288.10065,1998656.44,100833.1962,144354.8,144354.8,0.0,-145.47415
151.0,2656.7735,20160414 04:10:04 EST,20160414 04:10:04 EST,20160414 04:10:04 EST,30000.0,,BTCUSD_localbtcRUB,long,,20160414 03:36:11 EST,closed,20160414 03:36:11 EST,28525.3,,,2.0,2.0,,BTCUSD_localbtcRUB,,2949.4,-2.0,USD,103489.9697,292.6265,2001605.84,103489.9697,147304.2,147304.2,0.0,-142.6265
152.0,2092.8071,20160414 04:51:59 EST,20160414 04:51:59 EST,20160414 04:51:59 EST,28806.58,,BTCUSD_localbtcRUB,short,,20160414 04:10:04 EST,closed,20160414 04:10:04 EST,30000.0,,,2.0,2.0,,BTCUSD_localbtcRUB,,2386.84,2.0,USD,105582.7768,294.0329,1999219.0,105582.7768,149691.04,149691.04,0.0,-150.0
153.0,289.34705,20160414 05:02:32 EST,20160414 05:02:32 EST,20160414 05:02:32 EST,29096.01,,BTCUSD_localbtcRUB,long,,20160414 04:51:59 EST,closed,20160414 04:51:59 EST,28806.58,,,2.0,2.0,,BTCUSD_localbtcRUB,,578.86,-2.0,USD,105872.12385,289.51295,1999797.86,105872.12385,150269.9,150269.9,0.0,-144.0329
154.0,-264.4139,20160414 06:26:55 EST,20160414 06:26:55 EST,20160414 06:26:55 EST,29082.77,,BTCUSD_localbtcRUB,short,,20160414 05:02:32 EST,closed,20160414 05:02:32 EST,29096.01,,,2.0,2.0,,BTCUSD_localbtcRUB,,26.48,2.0,USD,105607.70995,290.8939,1999771.38,105607.70995,150296.38,150296.38,0.0,-145.48005
155.0,-484.8614,20160414 06:37:05 EST,20160414 06:37:05 EST,20160414 06:37:05 EST,28985.51,,BTCUSD_localbtcRUB,long,,20160414 06:26:55 EST,closed,20160414 06:26:55 EST,29082.77,,,2.0,2.0,,BTCUSD_localbtcRUB,,-194.52,-2.0,USD,105122.84855,290.3414,1999576.86,105122.84855,150101.86,150101.86,0.0,-145.41385
156.0,-542.5252,20160414 06:47:39 EST,20160414 06:47:39 EST,20160414 06:47:39 EST,29111.53,,BTCUSD_localbtcRUB,short,,20160414 06:37:05 EST,closed,20160414 06:37:05 EST,28985.51,,,2.0,2.0,,BTCUSD_localbtcRUB,,-252.04,2.0,USD,104580.32335,290.4852,1999828.9,104580.32335,149849.82,149849.82,0.0,-144.92755
157.0,-3266.8174,20160414 07:08:14 EST,20160414 07:08:14 EST,20160414 07:08:14 EST,27619.95,,BTCUSD_localbtcRUB,long,,20160414 06:47:39 EST,closed,20160414 06:47:39 EST,29111.53,,,2.0,2.0,,BTCUSD_localbtcRUB,,-2983.16,-2.0,USD,101313.50595,283.6574,1996845.74,101313.50595,146866.66,146866.66,0.0,-145.55765
158.0,-3119.6103,20160414 07:19:26 EST,20160414 07:19:26 EST,20160414 07:19:26 EST,29038.11,,BTCUSD_localbtcRUB,short,,20160414 07:08:14 EST,closed,20160414 07:08:14 EST,27619.95,,,2.0,2.0,,BTCUSD_localbtcRUB,,-2836.32,2.0,USD,98193.89565,283.2903,1999682.06,98193.89565,144030.34,144030.34,0.0,-138.09975
159.0,-185.0451,20160414 08:02:18 EST,20160414 08:02:18 EST,20160414 08:02:18 EST,29090.91,,BTCUSD_localbtcRUB,long,,20160414 07:19:26 EST,closed,20160414 07:19:26 EST,29038.11,,,2.0,2.0,,BTCUSD_localbtcRUB,,105.6,-2.0,USD,98008.85055,290.6451,1999787.66,98008.85055,144135.94,144135.94,0.0,-145.19055
160.0,1283.43695,20160414 08:23:59 EST,20160414 08:23:59 EST,20160414 08:23:59 EST,28305.7,,BTCUSD_localbtcRUB,short,,20160414 08:02:18 EST,closed,20160414 08:02:18 EST,29090.91,,,2.0,2.0,,BTCUSD_localbtcRUB,,1570.42,2.0,USD,99292.2875,286.98305,1998217.24,99292.2875,145706.36,145706.36,0.0,-145.45455
161.0,1073.16395,20160414 08:34:49 EST,20160414 08:34:49 EST,20160414 08:34:49 EST,28985.51,,BTCUSD_localbtcRUB,long,,20160414 08:23:59 EST,closed,20160414 08:23:59 EST,28305.7,,,2.0,2.0,,BTCUSD_localbtcRUB,,1359.62,-2.0,USD,100365.45145,286.45605,1999576.86,100365.45145,147065.98,147065.98,0.0,-141.5285
162.0,-430.566,20160414 08:57:12 EST,20160414 08:57:12 EST,20160414 08:57:12 EST,29055.69,,BTCUSD_localbtcRUB,short,,20160414 08:34:49 EST,closed,20160414 08:34:49 EST,28985.51,,,2.0,2.0,,BTCUSD_localbtcRUB,,-140.36,2.0,USD,99934.88545,290.206,1999717.22,99934.88545,146925.62,146925.62,0.0,-144.92755
163.0,-259.2354,20160414 09:18:43 EST,20160414 09:18:43 EST,20160414 09:18:43 EST,29071.39,,BTCUSD_localbtcRUB,long,,20160414 08:57:12 EST,closed,20160414 08:57:12 EST,29055.69,,,2.0,2.0,,BTCUSD_localbtcRUB,,31.4,-2.0,USD,99675.65005,290.6354,1999748.62,99675.65005,146957.02,146957.02,0.0,-145.27845
164.0,-731.3327,20160414 10:03:28 EST,20160414 10:03:28 EST,20160414 10:03:28 EST,29291.15,,BTCUSD_localbtcRUB,short,,20160414 09:18:43 EST,closed,20160414 09:18:43 EST,29071.39,,,2.0,2.0,,BTCUSD_localbtcRUB,,-439.52,2.0,USD,98944.31735,291.8127,2000188.14,98944.31735,146517.5,146517.5,0.0,-145.35695
165.0,-519.20435,20160414 10:26:16 EST,20160414 10:26:16 EST,20160414 10:26:16 EST,29177.72,,BTCUSD_localbtcRUB,long,,20160414 10:03:28 EST,closed,20160414 10:03:28 EST,29291.15,,,2.0,2.0,,BTCUSD_localbtcRUB,,-226.86,-2.0,USD,98425.113,292.34435,1999961.28,98425.113,146290.64,146290.64,0.0,-146.45575
166.0,-495.405,20160414 10:44:52 EST,20160414 10:44:52 EST,20160414 10:44:52 EST,29279.28,,BTCUSD_localbtcRUB,short,,20160414 10:26:16 EST,closed,20160414 10:26:16 EST,29177.72,,,2.0,2.0,,BTCUSD_localbtcRUB,,-203.12,2.0,USD,97929.708,292.285,2000164.4,97929.708,146087.52,146087.52,0.0,-145.8886
167.0,-456.7818,20160414 11:07:05 EST,20160414 11:07:05 EST,20160414 11:07:05 EST,29197.08,,BTCUSD_localbtcRUB,long,,20160414 10:44:52 EST,closed,20160414 10:44:52 EST,29279.28,,,2.0,2.0,,BTCUSD_localbtcRUB,,-164.4,-2.0,USD,97472.9262,292.3818,2000000.0,97472.9262,145923.12,145923.12,0.0,-146.3964
168.0,-492.0698,20160414 11:18:49 EST,20160414 11:18:49 EST,20160414 11:18:49 EST,29296.88,,BTCUSD_localbtcRUB,short,,20160414 11:07:05 EST,closed,20160414 11:07:05 EST,29197.08,,,2.0,2.0,,BTCUSD_localbtcRUB,,-199.6,2.0,USD,96980.8564,292.4698,2000199.6,96980.8564,145723.52,145723.52,0.0,-145.9854
169.0,86.6797,20160414 11:40:51 EST,20160414 11:40:51 EST,20160414 11:40:51 EST,29487.18,,BTCUSD_localbtcRUB,long,,20160414 11:18:49 EST,closed,20160414 11:18:49 EST,29296.88,,,2.0,2.0,,BTCUSD_localbtcRUB,,380.6,-2.0,USD,97067.5361,293.9203,2000580.2,97067.5361,146104.12,146104.12,0.0,-146.4844
170.0,184.86455,20160414 12:33:29 EST,20160414 12:33:29 EST,20160414 12:33:29 EST,29247.91,,BTCUSD_localbtcRUB,short,,20160414 11:40:51 EST,closed,20160414 11:40:51 EST,29487.18,,,2.0,2.0,,BTCUSD_localbtcRUB,,478.54,2.0,USD,97252.40065,293.67545,2000101.66,97252.40065,146582.66,146582.66,0.0,-147.4359
171.0,-454.5529,20160414 12:57:00 EST,20160414 12:57:00 EST,20160414 12:57:00 EST,29166.67,,BTCUSD_localbtcRUB,long,,20160414 12:33:29 EST,closed,20160414 12:33:29 EST,29247.91,,,2.0,2.0,,BTCUSD_localbtcRUB,,-162.48,-2.0,USD,96797.84775,292.0729,1999939.18,96797.84775,146420.18,146420.18,0.0,-146.23955
172.0,-531.8657,20160414 13:06:57 EST,20160414 13:06:57 EST,20160414 13:06:57 EST,29286.47,,BTCUSD_localbtcRUB,short,,20160414 12:57:00 EST,closed,20160414 12:57:00 EST,29166.67,,,2.0,2.0,,BTCUSD_localbtcRUB,,-239.6,2.0,USD,96265.98205,292.2657,2000178.78,96265.98205,146180.58,146180.58,0.0,-145.83335
173.0,-612.5834,20160414 13:19:03 EST,20160414 13:19:03 EST,20160414 13:19:03 EST,29126.21,,BTCUSD_localbtcRUB,long,,20160414 13:06:57 EST,closed,20160414 13:06:57 EST,29286.47,,,2.0,2.0,,BTCUSD_localbtcRUB,,-320.52,-2.0,USD,95653.39865,292.0634,1999858.26,95653.39865,145860.06,145860.06,0.0,-146.43235
174.0,-602.2777,20160414 15:16:39 EST,20160414 15:16:39 EST,20160414 15:16:39 EST,29281.33,,BTCUSD_localbtcRUB,short,,20160414 13:19:03 EST,closed,20160414 13:19:03 EST,29126.21,,,2.0,2.0,,BTCUSD_localbtcRUB,,-310.24,2.0,USD,95051.12095,292.0377,2000168.5,95051.12095,145549.82,145549.82,0.0,-145.63105
175.0,445.43645,20160414 16:03:56 EST,20160414 16:03:56 EST,20160414 16:03:56 EST,29651.38,,BTCUSD_localbtcRUB,long,,20160414 15:16:39 EST,closed,20160414 15:16:39 EST,29281.33,,,2.0,2.0,,BTCUSD_localbtcRUB,,740.1,-2.0,USD,95496.5574,294.66355,2000908.6,95496.5574,146289.92,146289.92,0.0,-146.40665
176.0,789.77515,20160414 16:26:38 EST,20160414 16:26:38 EST,20160414 16:26:38 EST,29109.59,,BTCUSD_localbtcRUB,short,,20160414 16:03:56 EST,closed,20160414 16:03:56 EST,29651.38,,,2.0,2.0,,BTCUSD_localbtcRUB,,1083.58,2.0,USD,96286.33255,293.80485,1999825.02,96286.33255,147373.5,147373.5,0.0,-148.2569
177.0,-922.8725,20160414 16:37:27 EST,20160414 16:37:27 EST,20160414 16:37:27 EST,28792.91,,BTCUSD_localbtcRUB,long,,20160414 16:26:38 EST,closed,20160414 16:26:38 EST,29109.59,,,2.0,2.0,,BTCUSD_localbtcRUB,,-633.36,-2.0,USD,95363.46005,289.5125,1999191.66,95363.46005,146740.14,146740.14,0.0,-145.54795
178.0,-157.3234,20160414 16:48:47 EST,20160414 16:48:47 EST,20160414 16:48:47 EST,28727.77,,BTCUSD_localbtcRUB,short,,20160414 16:37:27 EST,closed,20160414 16:37:27 EST,28792.91,,,2.0,2.0,,BTCUSD_localbtcRUB,,130.28,2.0,USD,95206.13665,287.6034,1999061.38,95206.13665,146870.42,146870.42,0.0,-143.96455
179.0,991.13825,20160414 17:16:57 EST,20160414 17:16:57 EST,20160414 17:16:57 EST,29368.58,,BTCUSD_localbtcRUB,long,,20160414 16:48:47 EST,closed,20160414 16:48:47 EST,28727.77,,,2.0,2.0,,BTCUSD_localbtcRUB,,1281.62,-2.0,USD,96197.2749,290.48175,2000343.0,96197.2749,148152.04,148152.04,0.0,-143.63885
180.0,305.42825,20160414 17:52:41 EST,20160414 17:52:41 EST,20160414 17:52:41 EST,29069.77,,BTCUSD_localbtcRUB,short,,20160414 17:16:57 EST,closed,20160414 17:16:57 EST,29368.58,,,2.0,2.0,,BTCUSD_localbtcRUB,,597.62,2.0,USD,96502.70315,292.19175,1999745.38,96502.70315,148749.66,148749.66,0.0,-146.8429
181.0,583.97015,20160414 18:37:19 EST,20160414 18:37:19 EST,20160414 18:37:19 EST,29508.2,,BTCUSD_localbtcRUB,long,,20160414 17:52:41 EST,closed,20160414 17:52:41 EST,29069.77,,,2.0,2.0,,BTCUSD_localbtcRUB,,876.86,-2.0,USD,97086.6733,292.88985,2000622.24,97086.6733,149626.52,149626.52,0.0,-145.34885
182.0,-2801.4924,20160414 19:05:34 EST,20160414 19:05:34 EST,20160414 19:05:34 EST,30758.28,,BTCUSD_localbtcRUB,short,,20160414 18:37:19 EST,closed,20160414 18:37:19 EST,29508.2,,,2.0,2.0,,BTCUSD_localbtcRUB,,-2500.16,2.0,USD,94285.1809,301.3324,2003122.4,94285.1809,147126.36,147126.36,0.0,-147.541
183.0,-2348.9865,20160414 19:33:35 EST,20160414 19:33:35 EST,20160414 19:33:35 EST,29735.02,,BTCUSD_localbtcRUB,long,,20160414 19:05:34 EST,closed,20160414 19:05:34 EST,30758.28,,,2.0,2.0,,BTCUSD_localbtcRUB,,-2046.52,-2.0,USD,91936.1944,302.4665,2001075.88,91936.1944,145079.84,145079.84,0.0,-153.7914
184.0,4816.50255,20160414 20:19:19 EST,20160414 20:19:19 EST,20160414 20:19:19 EST,27184.47,,BTCUSD_localbtcRUB,short,,20160414 19:33:35 EST,closed,20160414 19:33:35 EST,29735.02,,,2.0,2.0,,BTCUSD_localbtcRUB,,5101.1,2.0,USD,96752.69695,284.59745,1995974.78,96752.69695,150180.94,150180.94,0.0,-148.6751
185.0,4752.5628,20160414 22:11:33 EST,20160414 22:11:33 EST,20160414 22:11:33 EST,29702.97,,BTCUSD_localbtcRUB,long,,20160414 20:19:19 EST,closed,20160414 20:19:19 EST,27184.47,,,2.0,2.0,,BTCUSD_localbtcRUB,,5037.0,-2.0,USD,101505.25975,284.4372,2001011.78,101505.25975,155217.94,155217.94,0.0,-135.92235
186.0,112.8725,20160414 22:39:58 EST,20160414 22:39:58 EST,20160414 22:39:58 EST,29498.53,,BTCUSD_localbtcRUB,short,,20160414 22:11:33 EST,closed,20160414 22:11:33 EST,29702.97,,,2.0,2.0,,BTCUSD_localbtcRUB,,408.88,2.0,USD,101618.13225,296.0075,2000602.9,101618.13225,155626.82,155626.82,0.0,-148.51485
187.0,82.00985,20160415 00:19:43 EST,20160415 00:19:43 EST,20160415 00:19:43 EST,29687.5,,BTCUSD_localbtcRUB,long,,20160414 22:39:58 EST,closed,20160414 22:39:58 EST,29498.53,,,2.0,2.0,,BTCUSD_localbtcRUB,,377.94,-2.0,USD,101700.1421,295.93015,2000980.84,101700.1421,156004.76,156004.76,0.0,-147.49265
188.0,-277.96785,20160415 00:34:08 EST,20160415 00:34:08 EST,20160415 00:34:08 EST,29678.07,,BTCUSD_localbtcRUB,short,,20160415 00:19:43 EST,closed,20160415 00:19:43 EST,29687.5,,,2.0,2.0,,BTCUSD_localbtcRUB,,18.86,2.0,USD,101422.17425,296.82785,2000961.98,101422.17425,156023.62,156023.62,0.0,-148.4375
189.0,-205.46955,20160415 00:48:48 EST,20160415 00:48:48 EST,20160415 00:48:48 EST,29723.84,,BTCUSD_localbtcRUB,long,,20160415 00:34:08 EST,closed,20160415 00:34:08 EST,29678.07,,,2.0,2.0,,BTCUSD_localbtcRUB,,91.54,-2.0,USD,101216.7047,297.00955,2001053.52,101216.7047,156115.16,156115.16,0.0,-148.39035
190.0,-1663.78625,20160415 02:02:17 EST,20160415 02:02:17 EST,20160415 02:02:17 EST,30405.41,,BTCUSD_localbtcRUB,short,,20160415 00:48:48 EST,closed,20160415 00:48:48 EST,29723.84,,,2.0,2.0,,BTCUSD_localbtcRUB,,-1363.14,2.0,USD,99552.91845,300.64625,2002416.66,99552.91845,154752.02,154752.02,0.0,-148.6192
191.0,-3707.2448,20160415 02:47:11 EST,20160415 02:47:11 EST,20160415 02:47:11 EST,28699.55,,BTCUSD_localbtcRUB,long,,20160415 02:02:17 EST,closed,20160415 02:02:17 EST,30405.41,,,2.0,2.0,,BTCUSD_localbtcRUB,,-3411.72,-2.0,USD,95845.67365,295.5248,1999004.94,95845.67365,151340.3,151340.3,0.0,-152.02705
192.0,-2328.34615,20160415 04:02:56 EST,20160415 04:02:56 EST,20160415 04:02:56 EST,29717.68,,BTCUSD_localbtcRUB,short,,20160415 02:47:11 EST,closed,20160415 02:47:11 EST,28699.55,,,2.0,2.0,,BTCUSD_localbtcRUB,,-2036.26,2.0,USD,93517.3275,292.08615,2001041.2,93517.3275,149304.04,149304.04,0.0,-143.49775
193.0,-305.17675,20160415 04:17:54 EST,20160415 04:17:54 EST,20160415 04:17:54 EST,29713.67,,BTCUSD_localbtcRUB,long,,20160415 04:02:56 EST,closed,20160415 04:02:56 EST,29717.68,,,2.0,2.0,,BTCUSD_localbtcRUB,,-8.02,-2.0,USD,93212.15075,297.15675,2001033.18,93212.15075,149296.02,149296.02,0.0,-148.5884
194.0,308.19285,20160415 04:48:06 EST,20160415 04:48:06 EST,20160415 04:48:06 EST,29411.76,,BTCUSD_localbtcRUB,short,,20160415 04:17:54 EST,closed,20160415 04:17:54 EST,29713.67,,,2.0,2.0,,BTCUSD_localbtcRUB,,603.82,2.0,USD,93520.3436,295.62715,2000429.36,93520.3436,149899.84,149899.84,0.0,-148.56835
195.0,462.60585,20160415 05:33:37 EST,20160415 05:33:37 EST,20160415 05:33:37 EST,29791.07,,BTCUSD_localbtcRUB,long,,20160415 04:48:06 EST,closed,20160415 04:48:06 EST,29411.76,,,2.0,2.0,,BTCUSD_localbtcRUB,,758.62,-2.0,USD,93982.94945,296.01415,2001187.98,93982.94945,150658.46,150658.46,0.0,-147.0588
196.0,194.5574,20160415 06:19:04 EST,20160415 06:19:04 EST,20160415 06:19:04 EST,29545.45,,BTCUSD_localbtcRUB,short,,20160415 05:33:37 EST,closed,20160415 05:33:37 EST,29791.07,,,2.0,2.0,,BTCUSD_localbtcRUB,,491.24,2.0,USD,94177.50685,296.6826,2000696.74,94177.50685,151149.7,151149.7,0.0,-148.95535
197.0,234.31775,20160415 07:48:51 EST,20160415 07:48:51 EST,20160415 07:48:51 EST,29811.0,,BTCUSD_localbtcRUB,long,,20160415 06:19:04 EST,closed,20160415 06:19:04 EST,29545.45,,,2.0,2.0,,BTCUSD_localbtcRUB,,531.1,-2.0,USD,94411.8246,296.78225,2001227.84,94411.8246,151680.8,151680.8,0.0,-147.72725
198.0,34.7601,20160415 08:18:11 EST,20160415 08:18:11 EST,20160415 08:18:11 EST,29644.98,,BTCUSD_localbtcRUB,short,,20160415 07:48:51 EST,closed,20160415 07:48:51 EST,29811.0,,,2.0,2.0,,BTCUSD_localbtcRUB,,332.04,2.0,USD,94446.5847,297.2799,2000895.8,94446.5847,152012.84,152012.84,0.0,-149.055
199.0,402.65805,20160415 08:49:58 EST,20160415 08:49:58 EST,20160415 08:49:58 EST,29995.41,,BTCUSD_localbtcRUB,long,,20160415 08:18:11 EST,closed,20160415 08:18:11 EST,29644.98,,,2.0,2.0,,BTCUSD_localbtcRUB,,700.86,-2.0,USD,94849.24275,298.20195,2001596.66,94849.24275,152713.7,152713.7,0.0,-148.2249
200.0,-325.4176,20160415 09:22:07 EST,20160415 09:22:07 EST,20160415 09:22:07 EST,30008.11,,BTCUSD_localbtcRUB,short,,20160415 08:49:58 EST,closed,20160415 08:49:58 EST,29995.41,,,2.0,2.0,,BTCUSD_localbtcRUB,,-25.4,2.0,USD,94523.82515,300.0176,2001622.06,94523.82515,152688.3,152688.3,0.0,-149.97705
201.0,114.3203,20160415 09:37:25 EST,20160415 09:37:25 EST,20160415 09:37:25 EST,30215.83,,BTCUSD_localbtcRUB,long,,20160415 09:22:07 EST,closed,20160415 09:22:07 EST,30008.11,,,2.0,2.0,,BTCUSD_localbtcRUB,,415.44,-2.0,USD,94638.14545,301.1197,2002037.5,94638.14545,153103.74,153103.74,0.0,-150.04055
202.0,702.36675,20160415 09:53:49 EST,20160415 09:53:49 EST,20160415 09:53:49 EST,29714.82,,BTCUSD_localbtcRUB,short,,20160415 09:37:25 EST,closed,20160415 09:37:25 EST,30215.83,,,2.0,2.0,,BTCUSD_localbtcRUB,,1002.02,2.0,USD,95340.5122,299.65325,2001035.48,95340.5122,154105.76,154105.76,0.0,-151.07915
203.0,152.3253,20160415 10:09:07 EST,20160415 10:09:07 EST,20160415 10:09:07 EST,29940.12,,BTCUSD_localbtcRUB,long,,20160415 09:53:49 EST,closed,20160415 09:53:49 EST,29714.82,,,2.0,2.0,,BTCUSD_localbtcRUB,,450.6,-2.0,USD,95492.8375,298.2747,2001486.08,95492.8375,154556.36,154556.36,0.0,-148.5741
204.0,1595.003,20160415 11:06:12 EST,20160415 11:06:12 EST,20160415 11:06:12 EST,28995.28,,BTCUSD_localbtcRUB,short,,20160415 10:09:07 EST,closed,20160415 10:09:07 EST,29940.12,,,2.0,2.0,,BTCUSD_localbtcRUB,,1889.68,2.0,USD,97087.8405,294.677,1999596.4,97087.8405,156446.04,156446.04,0.0,-149.7006
205.0,1030.75715,20160415 11:22:35 EST,20160415 11:22:35 EST,20160415 11:22:35 EST,29657.29,,BTCUSD_localbtcRUB,long,,20160415 11:06:12 EST,closed,20160415 11:06:12 EST,28995.28,,,2.0,2.0,,BTCUSD_localbtcRUB,,1324.02,-2.0,USD,98118.59765,293.26285,2000920.42,98118.59765,157770.06,157770.06,0.0,-144.9764
206.0,-363.84065,20160415 11:55:30 EST,20160415 11:55:30 EST,20160415 11:55:30 EST,29690.84,,BTCUSD_localbtcRUB,short,,20160415 11:22:35 EST,closed,20160415 11:22:35 EST,29657.29,,,2.0,2.0,,BTCUSD_localbtcRUB,,-67.1,2.0,USD,97754.757,296.74065,2000987.52,97754.757,157702.96,157702.96,0.0,-148.28645
207.0,924.41065,20160415 12:10:35 EST,20160415 12:10:35 EST,20160415 12:10:35 EST,30303.03,,BTCUSD_localbtcRUB,long,,20160415 11:55:30 EST,closed,20160415 11:55:30 EST,29690.84,,,2.0,2.0,,BTCUSD_localbtcRUB,,1224.38,-2.0,USD,98679.16765,299.96935,2002211.9,98679.16765,158927.34,158927.34,0.0,-148.4542
208.0,3440.32475,20160415 13:14:41 EST,20160415 13:14:41 EST,20160415 13:14:41 EST,28436.02,,BTCUSD_localbtcRUB,short,,20160415 12:10:35 EST,closed,20160415 12:10:35 EST,30303.03,,,2.0,2.0,,BTCUSD_localbtcRUB,,3734.02,2.0,USD,102119.4924,293.69525,1998477.88,102119.4924,162661.36,162661.36,0.0,-151.51515
209.0,4182.10565,20160415 13:31:57 EST,20160415 13:31:57 EST,20160415 13:31:57 EST,30674.85,,BTCUSD_localbtcRUB,long,,20160415 13:14:41 EST,closed,20160415 13:14:41 EST,28436.02,,,2.0,2.0,,BTCUSD_localbtcRUB,,4477.66,-2.0,USD,106301.59805,295.55435,2002955.54,106301.59805,167139.02,167139.02,0.0,-142.1801
210.0,642.67915,20160415 14:04:26 EST,20160415 14:04:26 EST,20160415 14:04:26 EST,30201.32,,BTCUSD_localbtcRUB,short,,20160415 13:31:57 EST,closed,20160415 13:31:57 EST,30674.85,,,2.0,2.0,,BTCUSD_localbtcRUB,,947.06,2.0,USD,106944.2772,304.38085,2002008.48,106944.2772,168086.08,168086.08,0.0,-153.37425
211.0,201.06595,20160415 14:20:38 EST,20160415 14:20:38 EST,20160415 14:20:38 EST,30453.49,,BTCUSD_localbtcRUB,long,,20160415 14:04:26 EST,closed,20160415 14:04:26 EST,30201.32,,,2.0,2.0,,BTCUSD_localbtcRUB,,504.34,-2.0,USD,107145.34315,303.27405,2002512.82,107145.34315,168590.42,168590.42,0.0,-151.0066
212.0,-1762.7714,20160415 14:53:20 EST,20160415 14:53:20 EST,20160415 14:53:20 EST,31180.79,,BTCUSD_localbtcRUB,short,,20160415 14:20:38 EST,closed,20160415 14:20:38 EST,30453.49,,,2.0,2.0,,BTCUSD_localbtcRUB,,-1454.6,2.0,USD,105382.57175,308.1714,2003967.42,105382.57175,167135.82,167135.82,0.0,-152.26745
213.0,-871.98395,20160415 15:09:10 EST,20160415 15:09:10 EST,20160415 15:09:10 EST,30900.0,,BTCUSD_localbtcRUB,long,,20160415 14:53:20 EST,closed,20160415 14:53:20 EST,31180.79,,,2.0,2.0,,BTCUSD_localbtcRUB,,-561.58,-2.0,USD,104510.5878,310.40395,2003405.84,104510.5878,166574.24,166574.24,0.0,-155.90395
214.0,775.24385,20160415 15:42:22 EST,20160415 15:42:22 EST,20160415 15:42:22 EST,30359.23,,BTCUSD_localbtcRUB,short,,20160415 15:09:10 EST,closed,20160415 15:09:10 EST,30900.0,,,2.0,2.0,,BTCUSD_localbtcRUB,,1081.54,2.0,USD,105285.83165,306.29615,2002324.3,105285.83165,167655.78,167655.78,0.0,-154.5
215.0,1153.77515,20160415 16:32:51 EST,20160415 16:32:51 EST,20160415 16:32:51 EST,31089.74,,BTCUSD_localbtcRUB,long,,20160415 15:42:22 EST,closed,20160415 15:42:22 EST,30359.23,,,2.0,2.0,,BTCUSD_localbtcRUB,,1461.02,-2.0,USD,106439.6068,307.24485,2003785.32,106439.6068,169116.8,169116.8,0.0,-151.79615
216.0,-93.01405,20160415 16:49:15 EST,20160415 16:49:15 EST,20160415 16:49:15 EST,30981.07,,BTCUSD_localbtcRUB,short,,20160415 16:32:51 EST,closed,20160415 16:32:51 EST,31089.74,,,2.0,2.0,,BTCUSD_localbtcRUB,,217.34,2.0,USD,106346.59275,310.35405,2003567.98,106346.59275,169334.14,169334.14,0.0,-155.4487
217.0,-326.86795,20160415 17:05:59 EST,20160415 17:05:59 EST,20160415 17:05:59 EST,30972.52,,BTCUSD_localbtcRUB,long,,20160415 16:49:15 EST,closed,20160415 16:49:15 EST,30981.07,,,2.0,2.0,,BTCUSD_localbtcRUB,,-17.1,-2.0,USD,106019.7248,309.76795,2003550.88,106019.7248,169317.04,169317.04,0.0,-154.90535
218.0,154.33205,20160415 18:09:16 EST,20160415 18:09:16 EST,20160415 18:09:16 EST,30741.07,,BTCUSD_localbtcRUB,short,,20160415 17:05:59 EST,closed,20160415 17:05:59 EST,30972.52,,,2.0,2.0,,BTCUSD_localbtcRUB,,462.9,2.0,USD,106174.05685,308.56795,2003087.98,106174.05685,169779.94,169779.94,0.0,-154.8626
219.0,-696.5554,20160415 18:56:53 EST,20160415 18:56:53 EST,20160415 18:56:53 EST,30546.01,,BTCUSD_localbtcRUB,long,,20160415 18:09:16 EST,closed,20160415 18:09:16 EST,30741.07,,,2.0,2.0,,BTCUSD_localbtcRUB,,-390.12,-2.0,USD,105477.50145,306.4354,2002697.86,105477.50145,169389.82,169389.82,0.0,-153.70535
220.0,-313.25955,20160415 19:28:27 EST,20160415 19:28:27 EST,20160415 19:28:27 EST,30549.9,,BTCUSD_localbtcRUB,short,,20160415 18:56:53 EST,closed,20160415 18:56:53 EST,30546.01,,,2.0,2.0,,BTCUSD_localbtcRUB,,-7.78000000001,2.0,USD,105164.2419,305.47955,2002705.64,105164.2419,169382.04,169382.04,0.0,-152.73005
221.0,-1103.2995,20160415 19:43:50 EST,20160415 19:43:50 EST,20160415 19:43:50 EST,30150.0,,BTCUSD_localbtcRUB,long,,20160415 19:28:27 EST,closed,20160415 19:28:27 EST,30549.9,,,2.0,2.0,,BTCUSD_localbtcRUB,,-799.8,-2.0,USD,104060.9424,303.4995,2001905.84,104060.9424,168582.24,168582.24,0.0,-152.7495
222.0,-0.75,20160415 19:58:32 EST,20160415 19:58:32 EST,20160415 19:58:32 EST,30000.0,,BTCUSD_localbtcRUB,short,,20160415 19:43:50 EST,closed,20160415 19:43:50 EST,30150.0,,,2.0,2.0,,BTCUSD_localbtcRUB,,300.0,2.0,USD,104060.1924,300.75,2001605.84,104060.1924,168882.24,168882.24,0.0,-150.75
223.0,101.6733,20160415 20:12:41 EST,20160415 20:12:41 EST,20160415 20:12:41 EST,30201.34,,BTCUSD_localbtcRUB,long,,20160415 19:58:32 EST,closed,20160415 19:58:32 EST,30000.0,,,2.0,2.0,,BTCUSD_localbtcRUB,,402.68,-2.0,USD,104161.8657,301.0067,2002008.52,104161.8657,169284.92,169284.92,0.0,-150.0
224.0,-200.58045,20160415 20:41:30 EST,20160415 20:41:30 EST,20160415 20:41:30 EST,30150.75,,BTCUSD_localbtcRUB,short,,20160415 20:12:41 EST,closed,20160415 20:12:41 EST,30201.34,,,2.0,2.0,,BTCUSD_localbtcRUB,,101.18,2.0,USD,103961.28525,301.76045,2001907.34,103961.28525,169386.1,169386.1,0.0,-151.0067
225.0,1816.64385,20160415 21:59:39 EST,20160415 21:59:39 EST,20160415 21:59:39 EST,31212.48,,BTCUSD_localbtcRUB,long,,20160415 20:41:30 EST,closed,20160415 20:41:30 EST,30150.75,,,2.0,2.0,,BTCUSD_localbtcRUB,,2123.46,-2.0,USD,105777.9291,306.81615,2004030.8,105777.9291,171509.56,171509.56,0.0,-150.75375
226.0,868.55955,20160415 22:22:19 EST,20160415 22:22:19 EST,20160415 22:22:19 EST,30623.61,,BTCUSD_localbtcRUB,short,,20160415 21:59:39 EST,closed,20160415 21:59:39 EST,31212.48,,,2.0,2.0,,BTCUSD_localbtcRUB,,1177.74,2.0,USD,106646.48865,309.18045,2002853.06,106646.48865,172687.3,172687.3,0.0,-156.0624
227.0,1051.8402,20160415 22:46:51 EST,20160415 22:46:51 EST,20160415 22:46:51 EST,31304.35,,BTCUSD_localbtcRUB,long,,20160415 22:22:19 EST,closed,20160415 22:22:19 EST,30623.61,,,2.0,2.0,,BTCUSD_localbtcRUB,,1361.48,-2.0,USD,107698.32885,309.6398,2004214.54,107698.32885,174048.78,174048.78,0.0,-153.11805
228.0,1074.63705,20160415 23:10:33 EST,20160415 23:10:33 EST,20160415 23:10:33 EST,30612.24,,BTCUSD_localbtcRUB,short,,20160415 22:46:51 EST,closed,20160415 22:46:51 EST,31304.35,,,2.0,2.0,,BTCUSD_localbtcRUB,,1384.22,2.0,USD,108772.9659,309.58295,2002830.32,108772.9659,175433.0,175433.0,0.0,-156.52175
229.0,-1210.87485,20160415 23:34:26 EST,20160415 23:34:26 EST,20160415 23:34:26 EST,30158.73,,BTCUSD_localbtcRUB,long,,20160415 23:10:33 EST,closed,20160415 23:10:33 EST,30612.24,,,2.0,2.0,,BTCUSD_localbtcRUB,,-907.02,-2.0,USD,107562.09105,303.85485,2001923.3,107562.09105,174525.98,174525.98,0.0,-153.0612
230.0,2921.8512,20160415 23:47:05 EST,20160415 23:47:05 EST,20160415 23:47:05 EST,28551.03,,BTCUSD_localbtcRUB,short,,20160415 23:34:26 EST,closed,20160415 23:34:26 EST,30158.73,,,2.0,2.0,,BTCUSD_localbtcRUB,,3215.4,2.0,USD,110483.94225,293.5488,1998707.9,110483.94225,177741.38,177741.38,0.0,-150.79365
231.0,4979.27475,20160416 00:31:18 EST,20160416 00:31:18 EST,20160416 00:31:18 EST,31190.02,,BTCUSD_localbtcRUB,long,,20160415 23:47:05 EST,closed,20160415 23:47:05 EST,28551.03,,,2.0,2.0,,BTCUSD_localbtcRUB,,5277.98,-2.0,USD,115463.217,298.70525,2003985.88,115463.217,183019.36,183019.36,0.0,-142.75515
232.0,900.94435,20160416 00:57:33 EST,20160416 00:57:33 EST,20160416 00:57:33 EST,30585.11,,BTCUSD_localbtcRUB,short,,20160416 00:31:18 EST,closed,20160416 00:31:18 EST,31190.02,,,2.0,2.0,,BTCUSD_localbtcRUB,,1209.82,2.0,USD,116364.16135,308.87565,2002776.06,116364.16135,184229.18,184229.18,0.0,-155.9501
233.0,973.88155,20160416 01:09:51 EST,20160416 01:09:51 EST,20160416 01:09:51 EST,31226.58,,BTCUSD_localbtcRUB,long,,20160416 00:57:33 EST,closed,20160416 00:57:33 EST,30585.11,,,2.0,2.0,,BTCUSD_localbtcRUB,,1282.94,-2.0,USD,117338.0429,309.05845,2004059.0,117338.0429,185512.12,185512.12,0.0,-152.92555
234.0,793.95285,20160416 02:24:33 EST,20160416 02:24:33 EST,20160416 02:24:33 EST,30674.85,,BTCUSD_localbtcRUB,short,,20160416 01:09:51 EST,closed,20160416 01:09:51 EST,31226.58,,,2.0,2.0,,BTCUSD_localbtcRUB,,1103.46,2.0,USD,118131.99575,309.50715,2002955.54,118131.99575,186615.58,186615.58,0.0,-156.1329
235.0,801.73335,20160416 02:37:32 EST,20160416 02:37:32 EST,20160416 02:37:32 EST,31230.48,,BTCUSD_localbtcRUB,long,,20160416 02:24:33 EST,closed,20160416 02:24:33 EST,30674.85,,,2.0,2.0,,BTCUSD_localbtcRUB,,1111.26,-2.0,USD,118933.7291,309.52665,2004066.8,118933.7291,187726.84,187726.84,0.0,-153.37425
236.0,-188.69655,20160416 02:53:09 EST,20160416 02:53:09 EST,20160416 02:53:09 EST,31168.83,,BTCUSD_localbtcRUB,short,,20160416 02:37:32 EST,closed,20160416 02:37:32 EST,31230.48,,,2.0,2.0,,BTCUSD_localbtcRUB,,123.3,2.0,USD,118745.03255,311.99655,2003943.5,118745.03255,187850.14,187850.14,0.0,-156.1524
237.0,-462.41055,20160416 03:24:31 EST,20160416 03:24:31 EST,20160416 03:24:31 EST,31093.28,,BTCUSD_localbtcRUB,long,,20160416 02:53:09 EST,closed,20160416 02:53:09 EST,31168.83,,,2.0,2.0,,BTCUSD_localbtcRUB,,-151.1,-2.0,USD,118282.622,311.31055,2003792.4,118282.622,187699.04,187699.04,0.0,-155.84415
238.0,-63.37545,20160416 03:40:25 EST,20160416 03:40:25 EST,20160416 03:40:25 EST,30969.81,,BTCUSD_localbtcRUB,short,,20160416 03:24:31 EST,closed,20160416 03:24:31 EST,31093.28,,,2.0,2.0,,BTCUSD_localbtcRUB,,246.94,2.0,USD,118219.24655,310.31545,2003545.46,118219.24655,187945.98,187945.98,0.0,-155.4664
239.0,-154.84905,,,,0.0,,BTCUSD_localbtcRUB,long,,20160416 03:40:25 EST,open,20160416 03:40:25 EST,30969.81,,,0.0,2.0,,BTCUSD_localbtcRUB,,0.0,2.0,USD,118064.3975,154.84905,1941605.84,117909.54845,187945.98,187945.98,,
