trade_id,PL,closeVWAP_timestamp,closedWhen,closedWhenUnixTimeStamp,closing_price_VWAP,expir,instrument,long_or_short,markToMarket_time,openVWAP_timestamp,open_or_closed,openedWhen,opening_price_VWAP,ptValue,putcall,quant_closed,quant_opened,strike,symbol,symbol_description,PurePL,qty,currency,balance,commission,margin_available,mark_to_mkt,pure_mark_to_mkt,purebalance,pure_unr_pnl,unr_pnl
1.0,-1337.0059,20160416 10:51:46 EST,20160416 10:51:46 EST,20160416 10:51:46 EST,30487.2,,BTCUSD_localbtcRUB,long,,20160416 07:04:04 EST,closed,20160416 07:04:04 EST,31001.98,,,2.0,2.0,,BTCUSD_localbtcRUB,,-1029.56,-2.0,USD,98662.9941,307.4459,1998970.44,98662.9941,98970.44,98970.44,0.0,-155.0099
2.0,-93.8257,20160416 11:16:19 EST,20160416 11:16:19 EST,20160416 11:16:19 EST,30381.94,,BTCUSD_localbtcRUB,short,,20160416 10:51:46 EST,closed,20160416 10:51:46 EST,30487.2,,,2.0,2.0,,BTCUSD_localbtcRUB,,210.52,2.0,USD,98569.1684,304.3457,1998759.92,98569.1684,99180.96,99180.96,0.0,-152.436
3.0,-1057.23115,20160416 12:54:22 EST,20160416 12:54:22 EST,20160416 12:54:22 EST,30004.29,,BTCUSD_localbtcRUB,long,,20160416 11:16:19 EST,closed,20160416 11:16:19 EST,30381.94,,,2.0,2.0,,BTCUSD_localbtcRUB,,-755.3,-2.0,USD,97511.93725,301.93115,1998004.62,97511.93725,98425.66,98425.66,0.0,-151.9097
4.0,-1173.64145,20160416 13:06:03 EST,20160416 13:06:03 EST,20160416 13:06:03 EST,30440.0,,BTCUSD_localbtcRUB,short,,20160416 12:54:22 EST,closed,20160416 12:54:22 EST,30004.29,,,2.0,2.0,,BTCUSD_localbtcRUB,,-871.42,2.0,USD,96338.2958,302.22145,1998876.04,96338.2958,97554.24,97554.24,0.0,-150.02145
5.0,-86.72555,20160416 15:38:29 EST,20160416 15:38:29 EST,20160416 15:38:29 EST,30549.11,,BTCUSD_localbtcRUB,long,,20160416 13:06:03 EST,closed,20160416 13:06:03 EST,30440.0,,,2.0,2.0,,BTCUSD_localbtcRUB,,218.22,-2.0,USD,96251.57025,304.94555,1999094.26,96251.57025,97772.46,97772.46,0.0,-152.2
6.0,-0.55065,20160416 16:36:02 EST,20160416 16:36:02 EST,20160416 16:36:02 EST,30397.02,,BTCUSD_localbtcRUB,short,,20160416 15:38:29 EST,closed,20160416 15:38:29 EST,30549.11,,,2.0,2.0,,BTCUSD_localbtcRUB,,304.18,2.0,USD,96251.0196,304.73065,1998790.08,96251.0196,98076.64,98076.64,0.0,-152.74555
7.0,438.58875,20160416 17:48:02 EST,20160416 17:48:02 EST,20160416 17:48:02 EST,30769.23,,BTCUSD_localbtcRUB,long,,20160416 16:36:02 EST,closed,20160416 16:36:02 EST,30397.02,,,2.0,2.0,,BTCUSD_localbtcRUB,,744.42,-2.0,USD,96689.60835,305.83125,1999534.5,96689.60835,98821.06,98821.06,0.0,-151.9851
8.0,5844.4497,20160416 18:21:46 EST,20160416 18:21:46 EST,20160416 18:21:46 EST,27700.83,,BTCUSD_localbtcRUB,short,,20160416 17:48:02 EST,closed,20160416 17:48:02 EST,30769.23,,,2.0,2.0,,BTCUSD_localbtcRUB,,6136.8,2.0,USD,102534.05805,292.3503,1993397.7,102534.05805,104957.86,104957.86,0.0,-153.84615
9.0,6288.35715,20160416 18:34:00 EST,20160416 18:34:00 EST,20160416 18:34:00 EST,30991.74,,BTCUSD_localbtcRUB,long,,20160416 18:21:46 EST,closed,20160416 18:21:46 EST,27700.83,,,2.0,2.0,,BTCUSD_localbtcRUB,,6581.82,-2.0,USD,108822.4152,293.46285,1999979.52,108822.4152,111539.68,111539.68,0.0,-138.50415
10.0,520.4734,20160416 19:21:47 EST,20160416 19:21:47 EST,20160416 19:21:47 EST,30577.58,,BTCUSD_localbtcRUB,short,,20160416 18:34:00 EST,closed,20160416 18:34:00 EST,30991.74,,,2.0,2.0,,BTCUSD_localbtcRUB,,828.32,2.0,USD,109342.8886,307.8466,1999151.2,109342.8886,112368.0,112368.0,0.0,-154.9587
11.0,-628.34735,20160416 19:33:30 EST,20160416 19:33:30 EST,20160416 19:33:30 EST,30415.89,,BTCUSD_localbtcRUB,long,,20160416 19:21:47 EST,closed,20160416 19:21:47 EST,30577.58,,,2.0,2.0,,BTCUSD_localbtcRUB,,-323.38,-2.0,USD,108714.54125,304.96735,1998827.82,108714.54125,112044.62,112044.62,0.0,-152.8879
12.0,-1513.79545,20160416 20:10:12 EST,20160416 20:10:12 EST,20160416 20:10:12 EST,31019.2,,BTCUSD_localbtcRUB,short,,20160416 19:33:30 EST,closed,20160416 19:33:30 EST,30415.89,,,2.0,2.0,,BTCUSD_localbtcRUB,,-1206.62,2.0,USD,107200.7458,307.17545,2000034.44,107200.7458,110838.0,110838.0,0.0,-152.07945
13.0,-677.77075,20160416 20:34:53 EST,20160416 20:34:53 EST,20160416 20:34:53 EST,30834.95,,BTCUSD_localbtcRUB,long,,20160416 20:10:12 EST,closed,20160416 20:10:12 EST,31019.2,,,2.0,2.0,,BTCUSD_localbtcRUB,,-368.5,-2.0,USD,106522.97505,309.27075,1999665.94,106522.97505,110469.5,110469.5,0.0,-155.096
14.0,362.2428,20160416 20:48:57 EST,20160416 20:48:57 EST,20160416 20:48:57 EST,30500.49,,BTCUSD_localbtcRUB,short,,20160416 20:34:53 EST,closed,20160416 20:34:53 EST,30834.95,,,2.0,2.0,,BTCUSD_localbtcRUB,,668.92,2.0,USD,106885.21785,306.6772,1998997.02,106885.21785,111138.42,111138.42,0.0,-154.17475
15.0,590.5107,20160416 21:14:00 EST,20160416 21:14:00 EST,20160416 21:14:00 EST,30949.37,,BTCUSD_localbtcRUB,long,,20160416 20:48:57 EST,closed,20160416 20:48:57 EST,30500.49,,,2.0,2.0,,BTCUSD_localbtcRUB,,897.76,-2.0,USD,107475.72855,307.2493,1999894.78,107475.72855,112036.18,112036.18,0.0,-152.50245
16.0,-426.5456,20160416 21:27:00 EST,20160416 21:27:00 EST,20160416 21:27:00 EST,31007.75,,BTCUSD_localbtcRUB,short,,20160416 21:14:00 EST,closed,20160416 21:14:00 EST,30949.37,,,2.0,2.0,,BTCUSD_localbtcRUB,,-116.76,2.0,USD,107049.18295,309.7856,2000011.54,107049.18295,111919.42,111919.42,0.0,-154.74685
17.0,-440.5904,20160416 21:39:31 EST,20160416 21:39:31 EST,20160416 21:39:31 EST,30942.33,,BTCUSD_localbtcRUB,long,,20160416 21:27:00 EST,closed,20160416 21:27:00 EST,31007.75,,,2.0,2.0,,BTCUSD_localbtcRUB,,-130.84,-2.0,USD,106608.59255,309.7504,1999880.7,106608.59255,111788.58,111788.58,0.0,-155.03875
18.0,-1228.9965,20160416 22:18:06 EST,20160416 22:18:06 EST,20160416 22:18:06 EST,31400.97,,BTCUSD_localbtcRUB,short,,20160416 21:39:31 EST,closed,20160416 21:39:31 EST,30942.33,,,2.0,2.0,,BTCUSD_localbtcRUB,,-917.28,2.0,USD,105379.59605,311.7165,2000797.98,105379.59605,110871.3,110871.3,0.0,-154.71165
19.0,-615.19485,20160416 22:43:13 EST,20160416 22:43:13 EST,20160416 22:43:13 EST,31250.0,,BTCUSD_localbtcRUB,long,,20160416 22:18:06 EST,closed,20160416 22:18:06 EST,31400.97,,,2.0,2.0,,BTCUSD_localbtcRUB,,-301.94,-2.0,USD,104764.4012,313.25485,2000496.04,104764.4012,110569.36,110569.36,0.0,-157.00485
20.0,-34.02555,20160416 22:56:18 EST,20160416 22:56:18 EST,20160416 22:56:18 EST,31111.11,,BTCUSD_localbtcRUB,short,,20160416 22:43:13 EST,closed,20160416 22:43:13 EST,31250.0,,,2.0,2.0,,BTCUSD_localbtcRUB,,277.78,2.0,USD,104730.37565,311.80555,2000218.26,104730.37565,110847.14,110847.14,0.0,-156.25
21.0,663.70575,20160416 23:07:47 EST,20160416 23:07:47 EST,20160416 23:07:47 EST,31599.74,,BTCUSD_localbtcRUB,long,,20160416 22:56:18 EST,closed,20160416 22:56:18 EST,31111.11,,,2.0,2.0,,BTCUSD_localbtcRUB,,977.26,-2.0,USD,105394.0814,313.55425,2001195.52,105394.0814,111824.4,111824.4,0.0,-155.55555
22.0,1235.0706,20160416 23:57:36 EST,20160416 23:57:36 EST,20160416 23:57:36 EST,30826.14,,BTCUSD_localbtcRUB,short,,20160416 23:07:47 EST,closed,20160416 23:07:47 EST,31599.74,,,2.0,2.0,,BTCUSD_localbtcRUB,,1547.2,2.0,USD,106629.152,312.1294,1999648.32,106629.152,113371.6,113371.6,0.0,-157.9987
23.0,607.0047,20160417 00:23:39 EST,20160417 00:23:39 EST,20160417 00:23:39 EST,31284.92,,BTCUSD_localbtcRUB,long,,20160416 23:57:36 EST,closed,20160416 23:57:36 EST,30826.14,,,2.0,2.0,,BTCUSD_localbtcRUB,,917.56,-2.0,USD,107236.1567,310.5553,2000565.88,107236.1567,114289.16,114289.16,0.0,-154.1307
24.0,2142.8748,20160417 00:48:45 EST,20160417 00:48:45 EST,20160417 00:48:45 EST,30060.12,,BTCUSD_localbtcRUB,short,,20160417 00:23:39 EST,closed,20160417 00:23:39 EST,31284.92,,,2.0,2.0,,BTCUSD_localbtcRUB,,2449.6,2.0,USD,109379.0315,306.7252,1998116.28,109379.0315,116738.76,116738.76,0.0,-156.4246
25.0,846.1248,20160417 01:01:58 EST,20160417 01:01:58 EST,20160417 01:01:58 EST,30634.92,,BTCUSD_localbtcRUB,long,,20160417 00:48:45 EST,closed,20160417 00:48:45 EST,30060.12,,,2.0,2.0,,BTCUSD_localbtcRUB,,1149.6,-2.0,USD,110225.1563,303.4752,1999265.88,110225.1563,117888.36,117888.36,0.0,-150.3006
26.0,-512.4231,20160417 01:28:14 EST,20160417 01:28:14 EST,20160417 01:28:14 EST,30737.7,,BTCUSD_localbtcRUB,short,,20160417 01:01:58 EST,closed,20160417 01:01:58 EST,30634.92,,,2.0,2.0,,BTCUSD_localbtcRUB,,-205.56,2.0,USD,109712.7332,306.8631,1999471.44,109712.7332,117682.8,117682.8,0.0,-153.1746
27.0,-224.2254,20160417 01:53:51 EST,20160417 01:53:51 EST,20160417 01:53:51 EST,30779.38,,BTCUSD_localbtcRUB,long,,20160417 01:28:14 EST,closed,20160417 01:28:14 EST,30737.7,,,2.0,2.0,,BTCUSD_localbtcRUB,,83.36,-2.0,USD,109488.5078,307.5854,1999554.8,109488.5078,117766.16,117766.16,0.0,-153.6885
28.0,444.8431,20160417 02:04:25 EST,20160417 02:04:25 EST,20160417 02:04:25 EST,30404.0,,BTCUSD_localbtcRUB,short,,20160417 01:53:51 EST,closed,20160417 01:53:51 EST,30779.38,,,2.0,2.0,,BTCUSD_localbtcRUB,,750.76,2.0,USD,109933.3509,305.9169,1998804.04,109933.3509,118516.92,118516.92,0.0,-153.8969
29.0,683.2456,20160417 03:38:03 EST,20160417 03:38:03 EST,20160417 03:38:03 EST,30898.88,,BTCUSD_localbtcRUB,long,,20160417 02:04:25 EST,closed,20160417 02:04:25 EST,30404.0,,,2.0,2.0,,BTCUSD_localbtcRUB,,989.76,-2.0,USD,110616.5965,306.5144,1999793.8,110616.5965,119506.68,119506.68,0.0,-152.02
30.0,963.80525,20160417 05:09:00 EST,20160417 05:09:00 EST,20160417 05:09:00 EST,30264.07,,BTCUSD_localbtcRUB,short,,20160417 03:38:03 EST,closed,20160417 03:38:03 EST,30898.88,,,2.0,2.0,,BTCUSD_localbtcRUB,,1269.62,2.0,USD,111580.40175,305.81475,1998524.18,111580.40175,120776.3,120776.3,0.0,-154.4944
31.0,-27.98905,20160417 05:36:37 EST,20160417 05:36:37 EST,20160417 05:36:37 EST,30401.74,,BTCUSD_localbtcRUB,long,,20160417 05:09:00 EST,closed,20160417 05:09:00 EST,30264.07,,,2.0,2.0,,BTCUSD_localbtcRUB,,275.34,-2.0,USD,111552.4127,303.32905,1998799.52,111552.4127,121051.64,121051.64,0.0,-151.32035
32.0,-569.1586,20160417 05:50:06 EST,20160417 05:50:06 EST,20160417 05:50:06 EST,30533.98,,BTCUSD_localbtcRUB,short,,20160417 05:36:37 EST,closed,20160417 05:36:37 EST,30401.74,,,2.0,2.0,,BTCUSD_localbtcRUB,,-264.48,2.0,USD,110983.2541,304.6786,1999064.0,110983.2541,120787.16,120787.16,0.0,-152.0087
33.0,1262.59055,20160417 06:29:49 EST,20160417 06:29:49 EST,20160417 06:29:49 EST,31319.91,,BTCUSD_localbtcRUB,long,,20160417 05:50:06 EST,closed,20160417 05:50:06 EST,30533.98,,,2.0,2.0,,BTCUSD_localbtcRUB,,1571.86,-2.0,USD,112245.84465,309.26945,2000635.86,112245.84465,122359.02,122359.02,0.0,-152.6699
34.0,1095.57405,20160417 06:43:30 EST,20160417 06:43:30 EST,20160417 06:43:30 EST,30617.28,,BTCUSD_localbtcRUB,short,,20160417 06:29:49 EST,closed,20160417 06:29:49 EST,31319.91,,,2.0,2.0,,BTCUSD_localbtcRUB,,1405.26,2.0,USD,113341.4187,309.68595,1999230.6,113341.4187,123764.28,123764.28,0.0,-156.59955
35.0,-246.90135,20160417 06:57:17 EST,20160417 06:57:17 EST,20160417 06:57:17 EST,30646.99,,BTCUSD_localbtcRUB,long,,20160417 06:43:30 EST,closed,20160417 06:43:30 EST,30617.28,,,2.0,2.0,,BTCUSD_localbtcRUB,,59.42,-2.0,USD,113094.51735,306.32135,1999290.02,113094.51735,123823.7,123823.7,0.0,-153.0864
36.0,136.69525,20160417 07:36:30 EST,20160417 07:36:30 EST,20160417 07:36:30 EST,30425.96,,BTCUSD_localbtcRUB,short,,20160417 06:57:17 EST,closed,20160417 06:57:17 EST,30646.99,,,2.0,2.0,,BTCUSD_localbtcRUB,,442.06,2.0,USD,113231.2126,305.36475,1998847.96,113231.2126,124265.76,124265.76,0.0,-153.23495
37.0,-365.7455,20160417 08:03:24 EST,20160417 08:03:24 EST,20160417 08:03:24 EST,30395.14,,BTCUSD_localbtcRUB,long,,20160417 07:36:30 EST,closed,20160417 07:36:30 EST,30425.96,,,2.0,2.0,,BTCUSD_localbtcRUB,,-61.64,-2.0,USD,112865.4671,304.1055,1998786.32,112865.4671,124204.12,124204.12,0.0,-152.1298
38.0,-303.9514,20160417 08:16:22 EST,20160417 08:16:22 EST,20160417 08:16:22 EST,30395.14,,BTCUSD_localbtcRUB,short,,20160417 08:03:24 EST,closed,20160417 08:03:24 EST,30395.14,,,2.0,2.0,,BTCUSD_localbtcRUB,,0.0,2.0,USD,112561.5157,303.9514,1998786.32,112561.5157,124204.12,124204.12,0.0,-151.9757
39.0,-1191.8461,20160417 08:42:53 EST,20160417 08:42:53 EST,20160417 08:42:53 EST,29950.08,,BTCUSD_localbtcRUB,long,,20160417 08:16:22 EST,closed,20160417 08:16:22 EST,30395.14,,,2.0,2.0,,BTCUSD_localbtcRUB,,-890.12,-2.0,USD,111369.6696,301.7261,1997896.2,111369.6696,123314.0,123314.0,0.0,-151.9757
40.0,-1806.59915,20160417 08:56:15 EST,20160417 08:56:15 EST,20160417 08:56:15 EST,30701.75,,BTCUSD_localbtcRUB,short,,20160417 08:42:53 EST,closed,20160417 08:42:53 EST,29950.08,,,2.0,2.0,,BTCUSD_localbtcRUB,,-1503.34,2.0,USD,109563.07045,303.25915,1999399.54,109563.07045,121810.66,121810.66,0.0,-149.7504
41.0,-801.19895,20160417 09:10:22 EST,20160417 09:10:22 EST,20160417 09:10:22 EST,30454.04,,BTCUSD_localbtcRUB,long,,20160417 08:56:15 EST,closed,20160417 08:56:15 EST,30701.75,,,2.0,2.0,,BTCUSD_localbtcRUB,,-495.42,-2.0,USD,108761.8715,305.77895,1998904.12,108761.8715,121315.24,121315.24,0.0,-153.50875
42.0,-385.68275,20160417 09:24:44 EST,20160417 09:24:44 EST,20160417 09:24:44 EST,30494.51,,BTCUSD_localbtcRUB,short,,20160417 09:10:22 EST,closed,20160417 09:10:22 EST,30454.04,,,2.0,2.0,,BTCUSD_localbtcRUB,,-80.94,2.0,USD,108376.18875,304.74275,1998985.06,108376.18875,121234.3,121234.3,0.0,-152.2702
43.0,724.2754,20160417 09:38:33 EST,20160417 09:38:33 EST,20160417 09:38:33 EST,31010.41,,BTCUSD_localbtcRUB,long,,20160417 09:24:44 EST,closed,20160417 09:24:44 EST,30494.51,,,2.0,2.0,,BTCUSD_localbtcRUB,,1031.8,-2.0,USD,109100.46415,307.5246,2000016.86,109100.46415,122266.1,122266.1,0.0,-152.47255
44.0,902.9209,20160417 09:53:03 EST,20160417 09:53:03 EST,20160417 09:53:03 EST,30405.41,,BTCUSD_localbtcRUB,short,,20160417 09:38:33 EST,closed,20160417 09:38:33 EST,31010.41,,,2.0,2.0,,BTCUSD_localbtcRUB,,1210.0,2.0,USD,110003.38505,307.0791,1998806.86,110003.38505,123476.1,123476.1,0.0,-155.05205
45.0,179.893,20160417 10:47:17 EST,20160417 10:47:17 EST,20160417 10:47:17 EST,30647.99,,BTCUSD_localbtcRUB,long,,20160417 09:53:03 EST,closed,20160417 09:53:03 EST,30405.41,,,2.0,2.0,,BTCUSD_localbtcRUB,,485.16,-2.0,USD,110183.27805,305.267,1999292.02,110183.27805,123961.26,123961.26,0.0,-152.02705
46.0,93.6379,20160417 11:01:16 EST,20160417 11:01:16 EST,20160417 11:01:16 EST,30448.43,,BTCUSD_localbtcRUB,short,,20160417 10:47:17 EST,closed,20160417 10:47:17 EST,30647.99,,,2.0,2.0,,BTCUSD_localbtcRUB,,399.12,2.0,USD,110276.91595,305.4821,1998892.9,110276.91595,124360.38,124360.38,0.0,-153.23995
47.0,-304.4843,20160417 11:15:10 EST,20160417 11:15:10 EST,20160417 11:15:10 EST,30448.43,,BTCUSD_localbtcRUB,long,,20160417 11:01:16 EST,closed,20160417 11:01:16 EST,30448.43,,,2.0,2.0,,BTCUSD_localbtcRUB,,0.0,-2.0,USD,109972.43165,304.4843,1998892.9,109972.43165,124360.38,124360.38,0.0,-152.24215
48.0,-224.10385,20160417 11:38:31 EST,20160417 11:38:31 EST,20160417 11:38:31 EST,30408.34,,BTCUSD_localbtcRUB,short,,20160417 11:15:10 EST,closed,20160417 11:15:10 EST,30448.43,,,2.0,2.0,,BTCUSD_localbtcRUB,,80.18,2.0,USD,109748.3278,304.28385,1998812.72,109748.3278,124440.56,124440.56,0.0,-152.24215
49.0,-52.69345,20160417 12:06:49 EST,20160417 12:06:49 EST,20160417 12:06:49 EST,30534.35,,BTCUSD_localbtcRUB,long,,20160417 11:38:31 EST,closed,20160417 11:38:31 EST,30408.34,,,2.0,2.0,,BTCUSD_localbtcRUB,,252.02,-2.0,USD,109695.63435,304.71345,1999064.74,109695.63435,124692.58,124692.58,0.0,-152.0417
50.0,-881.92135,20160417 12:35:31 EST,20160417 12:35:31 EST,20160417 12:35:31 EST,30821.92,,BTCUSD_localbtcRUB,short,,20160417 12:06:49 EST,closed,20160417 12:06:49 EST,30534.35,,,2.0,2.0,,BTCUSD_localbtcRUB,,-575.14,2.0,USD,108813.713,306.78135,1999639.88,108813.713,124117.44,124117.44,0.0,-152.67175
51.0,-1274.61715,20160417 13:04:20 EST,20160417 13:04:20 EST,20160417 13:04:20 EST,30337.51,,BTCUSD_localbtcRUB,long,,20160417 12:35:31 EST,closed,20160417 12:35:31 EST,30821.92,,,2.0,2.0,,BTCUSD_localbtcRUB,,-968.82,-2.0,USD,107539.09585,305.79715,1998671.06,107539.09585,123148.62,123148.62,0.0,-154.1096
52.0,-524.90755,20160417 13:17:48 EST,20160417 13:17:48 EST,20160417 13:17:48 EST,30448.0,,BTCUSD_localbtcRUB,short,,20160417 13:04:20 EST,closed,20160417 13:04:20 EST,30337.51,,,2.0,2.0,,BTCUSD_localbtcRUB,,-220.98,2.0,USD,107014.1883,303.92755,1998892.04,107014.1883,122927.64,122927.64,0.0,-151.68755
53.0,-15.74365,20160417 13:42:07 EST,20160417 13:42:07 EST,20160417 13:42:07 EST,30592.73,,BTCUSD_localbtcRUB,long,,20160417 13:17:48 EST,closed,20160417 13:17:48 EST,30448.0,,,2.0,2.0,,BTCUSD_localbtcRUB,,289.46,-2.0,USD,106998.44465,305.20365,1999181.5,106998.44465,123217.1,123217.1,0.0,-152.24
54.0,377.03585,20160417 14:22:24 EST,20160417 14:22:24 EST,20160417 14:22:24 EST,30252.1,,BTCUSD_localbtcRUB,short,,20160417 13:42:07 EST,closed,20160417 13:42:07 EST,30592.73,,,2.0,2.0,,BTCUSD_localbtcRUB,,681.26,2.0,USD,107375.4805,304.22415,1998500.24,107375.4805,123898.36,123898.36,0.0,-152.96365
55.0,-1186.96435,20160417 14:51:22 EST,20160417 14:51:22 EST,20160417 14:51:22 EST,29808.77,,BTCUSD_localbtcRUB,long,,20160417 14:22:24 EST,closed,20160417 14:22:24 EST,30252.1,,,2.0,2.0,,BTCUSD_localbtcRUB,,-886.66,-2.0,USD,106188.51615,300.30435,1997613.58,106188.51615,123011.7,123011.7,0.0,-151.2605
56.0,-1362.8229,20160417 15:30:26 EST,20160417 15:30:26 EST,20160417 15:30:26 EST,30339.81,,BTCUSD_localbtcRUB,short,,20160417 14:51:22 EST,closed,20160417 14:51:22 EST,29808.77,,,2.0,2.0,,BTCUSD_localbtcRUB,,-1062.08,2.0,USD,104825.69325,300.7429,1998675.66,104825.69325,121949.62,121949.62,0.0,-149.04385
57.0,-437.103,20160417 15:42:48 EST,20160417 15:42:48 EST,20160417 15:42:48 EST,30272.79,,BTCUSD_localbtcRUB,long,,20160417 15:30:26 EST,closed,20160417 15:30:26 EST,30339.81,,,2.0,2.0,,BTCUSD_localbtcRUB,,-134.04,-2.0,USD,104388.59025,303.063,1998541.62,104388.59025,121815.58,121815.58,0.0,-151.69905
58.0,2354.7392,20160417 15:57:12 EST,20160417 15:57:12 EST,20160417 15:57:12 EST,28947.37,,BTCUSD_localbtcRUB,short,,20160417 15:42:48 EST,closed,20160417 15:42:48 EST,30272.79,,,2.0,2.0,,BTCUSD_localbtcRUB,,2650.84,2.0,USD,106743.32945,296.1008,1995890.78,106743.32945,124466.42,124466.42,0.0,-151.36395
59.0,1691.06255,20160417 16:10:39 EST,20160417 16:10:39 EST,20160417 16:10:39 EST,29940.12,,BTCUSD_localbtcRUB,long,,20160417 15:57:12 EST,closed,20160417 15:57:12 EST,28947.37,,,2.0,2.0,,BTCUSD_localbtcRUB,,1985.5,-2.0,USD,108434.392,294.43745,1997876.28,108434.392,126451.92,126451.92,0.0,-144.73685
60.0,-1027.03575,20160417 16:36:55 EST,20160417 16:36:55 EST,20160417 16:36:55 EST,30303.03,,BTCUSD_localbtcRUB,short,,20160417 16:10:39 EST,closed,20160417 16:10:39 EST,29940.12,,,2.0,2.0,,BTCUSD_localbtcRUB,,-725.82,2.0,USD,107407.35625,301.21575,1998602.1,107407.35625,125726.1,125726.1,0.0,-149.7006
61.0,-693.0528,20160417 17:05:11 EST,20160417 17:05:11 EST,20160417 17:05:11 EST,30107.53,,BTCUSD_localbtcRUB,long,,20160417 16:36:55 EST,closed,20160417 16:36:55 EST,30303.03,,,2.0,2.0,,BTCUSD_localbtcRUB,,-391.0,-2.0,USD,106714.30345,302.0528,1998211.1,106714.30345,125335.1,125335.1,0.0,-151.51515
62.0,-693.0528,20160417 18:28:27 EST,20160417 18:28:27 EST,20160417 18:28:27 EST,30303.03,,BTCUSD_localbtcRUB,short,,20160417 17:05:11 EST,closed,20160417 17:05:11 EST,30107.53,,,2.0,2.0,,BTCUSD_localbtcRUB,,-391.0,2.0,USD,106021.25065,302.0528,1998602.1,106021.25065,124944.1,124944.1,0.0,-150.53765
63.0,-330.6411,20160417 18:43:10 EST,20160417 18:43:10 EST,20160417 18:43:10 EST,30289.19,,BTCUSD_localbtcRUB,long,,20160417 18:28:27 EST,closed,20160417 18:28:27 EST,30303.03,,,2.0,2.0,,BTCUSD_localbtcRUB,,-27.68,-2.0,USD,105690.60955,302.9611,1998574.42,105690.60955,124916.42,124916.42,0.0,-151.51515
64.0,-322.5409,20160417 19:07:39 EST,20160417 19:07:39 EST,20160417 19:07:39 EST,30298.99,,BTCUSD_localbtcRUB,short,,20160417 18:43:10 EST,closed,20160417 18:43:10 EST,30289.19,,,2.0,2.0,,BTCUSD_localbtcRUB,,-19.6,2.0,USD,105368.06865,302.9409,1998594.02,105368.06865,124896.82,124896.82,0.0,-151.44595
65.0,-2004.8047,20160417 19:20:09 EST,20160417 19:20:09 EST,20160417 19:20:09 EST,29445.95,,BTCUSD_localbtcRUB,long,,20160417 19:07:39 EST,closed,20160417 19:07:39 EST,30298.99,,,2.0,2.0,,BTCUSD_localbtcRUB,,-1706.08,-2.0,USD,103363.26395,298.7247,1996887.94,103363.26395,123190.74,123190.74,0.0,-151.49495
66.0,-1111.71755,20160417 19:35:10 EST,20160417 19:35:10 EST,20160417 19:35:10 EST,29853.56,,BTCUSD_localbtcRUB,short,,20160417 19:20:09 EST,closed,20160417 19:20:09 EST,29445.95,,,2.0,2.0,,BTCUSD_localbtcRUB,,-815.22,2.0,USD,102251.5464,296.49755,1997703.16,102251.5464,122375.52,122375.52,0.0,-147.22975
67.0,598.15705,20160417 19:49:56 EST,20160417 19:49:56 EST,20160417 19:49:56 EST,30303.03,,BTCUSD_localbtcRUB,long,,20160417 19:35:10 EST,closed,20160417 19:35:10 EST,29853.56,,,2.0,2.0,,BTCUSD_localbtcRUB,,898.94,-2.0,USD,102849.70345,300.78295,1998602.1,102849.70345,123274.46,123274.46,0.0,-149.2678
68.0,-860.44035,20160417 21:25:06 EST,20160417 21:25:06 EST,20160417 21:25:06 EST,30581.04,,BTCUSD_localbtcRUB,short,,20160417 19:49:56 EST,closed,20160417 19:49:56 EST,30303.03,,,2.0,2.0,,BTCUSD_localbtcRUB,,-556.02,2.0,USD,101989.2631,304.42035,1999158.12,101989.2631,122718.44,122718.44,0.0,-151.51515
69.0,1385.01195,20160417 21:39:13 EST,20160417 21:39:13 EST,20160417 21:39:13 EST,31428.57,,BTCUSD_localbtcRUB,long,,20160417 21:25:06 EST,closed,20160417 21:25:06 EST,30581.04,,,2.0,2.0,,BTCUSD_localbtcRUB,,1695.06,-2.0,USD,103374.27505,310.04805,2000853.18,103374.27505,124413.5,124413.5,0.0,-152.9052
70.0,5997.51445,20160417 21:53:56 EST,20160417 21:53:56 EST,20160417 21:53:56 EST,28280.54,,BTCUSD_localbtcRUB,short,,20160417 21:39:13 EST,closed,20160417 21:39:13 EST,31428.57,,,2.0,2.0,,BTCUSD_localbtcRUB,,6296.06,2.0,USD,109371.7895,298.54555,1994557.12,109371.7895,130709.56,130709.56,0.0,-157.14285
71.0,3215.36725,20160417 22:21:57 EST,20160417 22:21:57 EST,20160417 22:21:57 EST,30034.01,,BTCUSD_localbtcRUB,long,,20160417 21:53:56 EST,closed,20160417 21:53:56 EST,28280.54,,,2.0,2.0,,BTCUSD_localbtcRUB,,3506.94,-2.0,USD,112587.15675,291.57275,1998064.06,112587.15675,134216.5,134216.5,0.0,-141.4027
72.0,-1585.2243,20160417 23:18:55 EST,20160417 23:18:55 EST,20160417 23:18:55 EST,30674.85,,BTCUSD_localbtcRUB,short,,20160417 22:21:57 EST,closed,20160417 22:21:57 EST,30034.01,,,2.0,2.0,,BTCUSD_localbtcRUB,,-1281.68,2.0,USD,111001.93245,303.5443,1999345.74,111001.93245,132934.82,132934.82,0.0,-150.17005
73.0,70.1868,20160417 23:48:50 EST,20160417 23:48:50 EST,20160417 23:48:50 EST,30863.79,,BTCUSD_localbtcRUB,long,,20160417 23:18:55 EST,closed,20160417 23:18:55 EST,30674.85,,,2.0,2.0,,BTCUSD_localbtcRUB,,377.88,-2.0,USD,111072.11925,307.6932,1999723.62,111072.11925,133312.7,133312.7,0.0,-153.37425
74.0,-815.1009,20160418 01:14:49 EST,20160418 01:14:49 EST,20160418 01:14:49 EST,31116.39,,BTCUSD_localbtcRUB,short,,20160417 23:48:50 EST,closed,20160417 23:48:50 EST,30863.79,,,2.0,2.0,,BTCUSD_localbtcRUB,,-505.2,2.0,USD,110257.01835,309.9009,2000228.82,110257.01835,132807.5,132807.5,0.0,-154.31895
75.0,-4433.3127,20160418 01:29:51 EST,20160418 01:29:51 EST,20160418 01:29:51 EST,29050.15,,BTCUSD_localbtcRUB,long,,20160418 01:14:49 EST,closed,20160418 01:14:49 EST,31116.39,,,2.0,2.0,,BTCUSD_localbtcRUB,,-4132.48,-2.0,USD,105823.70565,300.8327,1996096.34,105823.70565,128675.02,128675.02,0.0,-155.58195
76.0,-2421.35535,20160418 01:44:16 EST,20160418 01:44:16 EST,20160418 01:44:16 EST,30112.92,,BTCUSD_localbtcRUB,short,,20160418 01:29:51 EST,closed,20160418 01:29:51 EST,29050.15,,,2.0,2.0,,BTCUSD_localbtcRUB,,-2125.54,2.0,USD,103402.3503,295.81535,1998221.88,103402.3503,126549.48,126549.48,0.0,-145.25075
77.0,-323.89215,20160418 01:57:05 EST,20160418 01:57:05 EST,20160418 01:57:05 EST,30101.51,,BTCUSD_localbtcRUB,long,,20160418 01:44:16 EST,closed,20160418 01:44:16 EST,30112.92,,,2.0,2.0,,BTCUSD_localbtcRUB,,-22.82,-2.0,USD,103078.45815,301.07215,1998199.06,103078.45815,126526.66,126526.66,0.0,-150.5646
78.0,1868.89615,20160418 02:52:36 EST,20160418 02:52:36 EST,20160418 02:52:36 EST,29019.26,,BTCUSD_localbtcRUB,short,,20160418 01:57:05 EST,closed,20160418 01:57:05 EST,30101.51,,,2.0,2.0,,BTCUSD_localbtcRUB,,2164.5,2.0,USD,104947.3543,295.60385,1996034.56,104947.3543,128691.16,128691.16,0.0,-150.50755
79.0,-228.8663,20160418 03:06:04 EST,20160418 03:06:04 EST,20160418 03:06:04 EST,29050.0,,BTCUSD_localbtcRUB,long,,20160418 02:52:36 EST,closed,20160418 02:52:36 EST,29019.26,,,2.0,2.0,,BTCUSD_localbtcRUB,,61.48,-2.0,USD,104718.488,290.3463,1996096.04,104718.488,128752.64,128752.64,0.0,-145.0963
80.0,-2039.261,20160418 04:17:53 EST,20160418 04:17:53 EST,20160418 04:17:53 EST,29922.2,,BTCUSD_localbtcRUB,short,,20160418 03:06:04 EST,closed,20160418 03:06:04 EST,29050.0,,,2.0,2.0,,BTCUSD_localbtcRUB,,-1744.4,2.0,USD,102679.227,294.861,1997840.44,102679.227,127008.24,127008.24,0.0,-145.25
81.0,-312.20945,20160418 05:47:33 EST,20160418 05:47:33 EST,20160418 05:47:33 EST,29915.69,,BTCUSD_localbtcRUB,long,,20160418 04:17:53 EST,closed,20160418 04:17:53 EST,29922.2,,,2.0,2.0,,BTCUSD_localbtcRUB,,-13.02,-2.0,USD,102367.01755,299.18945,1997827.42,102367.01755,126995.22,126995.22,0.0,-149.611
82.0,-36.20115,20160418 06:02:47 EST,20160418 06:02:47 EST,20160418 06:02:47 EST,29784.54,,BTCUSD_localbtcRUB,short,,20160418 05:47:33 EST,closed,20160418 05:47:33 EST,29915.69,,,2.0,2.0,,BTCUSD_localbtcRUB,,262.3,2.0,USD,102330.8164,298.50115,1997565.12,102330.8164,127257.52,127257.52,0.0,-149.57845
83.0,-297.8454,20160418 06:14:33 EST,20160418 06:14:33 EST,20160418 06:14:33 EST,29784.54,,BTCUSD_localbtcRUB,long,,20160418 06:02:47 EST,closed,20160418 06:02:47 EST,29784.54,,,2.0,2.0,,BTCUSD_localbtcRUB,,0.0,-2.0,USD,102032.971,297.8454,1997565.12,102032.971,127257.52,127257.52,0.0,-148.9227
84.0,-240.06495,20160418 06:44:28 EST,20160418 06:44:28 EST,20160418 06:44:28 EST,30157.08,,BTCUSD_localbtcRUB,short,,20160418 06:30:20 EST,closed,20160418 06:30:20 EST,30187.91,,,2.0,2.0,,BTCUSD_localbtcRUB,,61.66,2.0,USD,101792.90605,301.72495,1997503.46,101792.90605,127319.18,127319.18,0.0,-150.93955
85.0,-838.545,20160418 07:31:08 EST,20160418 07:31:08 EST,20160418 07:31:08 EST,29887.92,,BTCUSD_localbtcRUB,long,,20160418 06:44:28 EST,closed,20160418 06:44:28 EST,30157.08,,,2.0,2.0,,BTCUSD_localbtcRUB,,-538.32,-2.0,USD,100954.36105,300.225,1996965.14,100954.36105,126780.86,126780.86,0.0,-150.7854
86.0,467.7125,20160418 07:48:05 EST,20160418 07:48:05 EST,20160418 07:48:05 EST,29505.58,,BTCUSD_localbtcRUB,short,,20160418 07:31:08 EST,closed,20160418 07:31:08 EST,29887.92,,,2.0,2.0,,BTCUSD_localbtcRUB,,764.68,2.0,USD,101422.07355,296.9675,1996200.46,101422.07355,127545.54,127545.54,106.16,-43.545
87.0,691.3121,20160418 08:36:02 EST,20160418 08:36:02 EST,20160418 08:36:02 EST,30000.0,,BTCUSD_localbtcRUB,long,,20160418 07:48:05 EST,closed,20160418 07:48:05 EST,29505.58,,,2.0,2.0,,BTCUSD_localbtcRUB,,988.84,-2.0,USD,102113.38565,297.5279,1997189.3,102113.38565,128534.38,128534.38,0.0,-147.5279
88.0,-257.07295,20160418 08:51:28 EST,20160418 08:51:28 EST,20160418 08:51:28 EST,29978.59,,BTCUSD_localbtcRUB,short,,20160418 08:36:02 EST,closed,20160418 08:36:02 EST,30000.0,,,2.0,2.0,,BTCUSD_localbtcRUB,,42.82,2.0,USD,101856.3127,299.89295,1997146.48,101856.3127,128577.2,128577.2,0.0,-150.0
89.0,-257.07295,20160418 10:49:46 EST,20160418 10:49:46 EST,20160418 10:49:46 EST,30000.0,,BTCUSD_localbtcRUB,long,,20160418 08:51:28 EST,closed,20160418 08:51:28 EST,29978.59,,,2.0,2.0,,BTCUSD_localbtcRUB,,42.82,-2.0,USD,101599.23975,299.89295,1997189.3,101599.23975,128620.02,128620.02,0.0,-149.89295
90.0,-999.76505,20160418 13:04:57 EST,20160418 13:04:57 EST,20160418 13:04:57 EST,30349.01,,BTCUSD_localbtcRUB,short,,20160418 10:49:46 EST,closed,20160418 10:49:46 EST,30000.0,,,2.0,2.0,,BTCUSD_localbtcRUB,,-698.02,2.0,USD,100599.4747,301.74505,1997887.32,100599.4747,127922.0,127922.0,0.0,-150.0
91.0,-1783.91975,20160418 13:39:05 EST,20160418 13:39:05 EST,20160418 13:39:05 EST,29606.94,,BTCUSD_localbtcRUB,long,,20160418 13:04:57 EST,closed,20160418 13:04:57 EST,30349.01,,,2.0,2.0,,BTCUSD_localbtcRUB,,-1484.14,-2.0,USD,98815.55495,299.77975,1996403.18,98815.55495,126437.86,126437.86,0.0,-151.74505
92.0,-375.4273,20160418 13:57:29 EST,20160418 13:57:29 EST,20160418 13:57:29 EST,29646.52,,BTCUSD_localbtcRUB,short,,20160418 13:39:05 EST,closed,20160418 13:39:05 EST,29606.94,,,2.0,2.0,,BTCUSD_localbtcRUB,,-79.16,2.0,USD,98440.12765,296.2673,1996482.34,98440.12765,126358.7,126358.7,0.0,-148.0347
93.0,1358.72645,20160418 14:12:28 EST,20160418 14:12:28 EST,20160418 14:12:28 EST,30476.19,,BTCUSD_localbtcRUB,long,,20160418 13:57:29 EST,closed,20160418 13:57:29 EST,29646.52,,,2.0,2.0,,BTCUSD_localbtcRUB,,1659.34,-2.0,USD,99798.8541,300.61355,1998141.68,99798.8541,128018.04,128018.04,0.0,-148.2326
94.0,1852.4176,20160418 14:44:33 EST,20160418 14:44:33 EST,20160418 14:44:33 EST,29400.29,,BTCUSD_localbtcRUB,short,,20160418 14:12:28 EST,closed,20160418 14:12:28 EST,30476.19,,,2.0,2.0,,BTCUSD_localbtcRUB,,2151.8,2.0,USD,101651.2717,299.3824,1995989.88,101651.2717,130169.84,130169.84,0.0,-152.38095
95.0,203.37055,20160418 15:01:28 EST,20160418 15:01:28 EST,20160418 15:01:28 EST,29649.6,,BTCUSD_localbtcRUB,long,,20160418 14:44:33 EST,closed,20160418 14:44:33 EST,29400.29,,,2.0,2.0,,BTCUSD_localbtcRUB,,498.62,-2.0,USD,101854.64225,295.24945,1996488.5,101854.64225,130668.46,130668.46,0.0,-147.00145
96.0,205.13495,20160418 15:18:05 EST,20160418 15:18:05 EST,20160418 15:18:05 EST,29399.41,,BTCUSD_localbtcRUB,short,,20160418 15:01:28 EST,closed,20160418 15:01:28 EST,29649.6,,,2.0,2.0,,BTCUSD_localbtcRUB,,500.38,2.0,USD,102059.7772,295.24505,1995988.12,102059.7772,131168.84,131168.84,0.0,-148.248
97.0,-1119.7246,20160418 15:53:27 EST,20160418 15:53:27 EST,20160418 15:53:27 EST,28985.51,,BTCUSD_localbtcRUB,long,,20160418 15:18:05 EST,closed,20160418 15:18:05 EST,29399.41,,,2.0,2.0,,BTCUSD_localbtcRUB,,-827.8,-2.0,USD,100940.0526,291.9246,1995160.32,100940.0526,130341.04,130341.04,0.0,-146.99705
98.0,-2120.0993,20160418 16:09:34 EST,20160418 16:09:34 EST,20160418 16:09:34 EST,29898.35,,BTCUSD_localbtcRUB,short,,20160418 15:53:27 EST,closed,20160418 15:53:27 EST,28985.51,,,2.0,2.0,,BTCUSD_localbtcRUB,,-1825.68,2.0,USD,98819.9533,294.4193,1996986.0,98819.9533,128515.36,128515.36,0.0,-144.92755
99.0,690.83575,20160418 16:39:20 EST,20160418 16:39:20 EST,20160418 16:39:20 EST,30394.5,,BTCUSD_localbtcRUB,long,,20160418 16:09:34 EST,closed,20160418 16:09:34 EST,29898.35,,,2.0,2.0,,BTCUSD_localbtcRUB,,992.3,-2.0,USD,99510.78905,301.46425,1997978.3,99510.78905,129507.66,129507.66,0.0,-149.49175
100.0,1078.6629,20160418 18:11:01 EST,20160418 18:11:01 EST,20160418 18:11:01 EST,29704.92,,BTCUSD_localbtcRUB,short,,20160418 16:39:20 EST,closed,20160418 16:39:20 EST,30394.5,,,2.0,2.0,,BTCUSD_localbtcRUB,,1379.16,2.0,USD,100589.45195,300.4971,1996599.14,100589.45195,130886.82,130886.82,0.0,-151.9725
101.0,563.1549,20160418 18:43:08 EST,20160418 18:43:08 EST,20160418 18:43:08 EST,30136.1,,BTCUSD_localbtcRUB,long,,20160418 18:11:01 EST,closed,20160418 18:11:01 EST,29704.92,,,2.0,2.0,,BTCUSD_localbtcRUB,,862.36,-2.0,USD,101152.60685,299.2051,1997461.5,101152.60685,131749.18,131749.18,0.0,-148.5246
102.0,974.0195,20160418 18:58:12 EST,20160418 18:58:12 EST,20160418 18:58:12 EST,29500.0,,BTCUSD_localbtcRUB,short,,20160418 18:43:08 EST,closed,20160418 18:43:08 EST,30136.1,,,2.0,2.0,,BTCUSD_localbtcRUB,,1272.2,2.0,USD,102126.62635,298.1805,1996189.3,102126.62635,133021.38,133021.38,0.0,-150.6805
103.0,-3421.165,20160418 19:13:26 EST,20160418 19:13:26 EST,20160418 19:13:26 EST,27933.0,,BTCUSD_localbtcRUB,long,,20160418 18:58:12 EST,closed,20160418 18:58:12 EST,29500.0,,,2.0,2.0,,BTCUSD_localbtcRUB,,-3134.0,-2.0,USD,98705.46135,287.165,1993055.3,98705.46135,129887.38,129887.38,0.0,-147.5
104.0,-4012.9608,20160418 20:29:05 EST,20160418 20:29:05 EST,20160418 20:29:05 EST,29795.16,,BTCUSD_localbtcRUB,short,,20160418 19:13:26 EST,closed,20160418 19:13:26 EST,27933.0,,,2.0,2.0,,BTCUSD_localbtcRUB,,-3724.32,2.0,USD,94692.50055,288.6408,1996779.62,94692.50055,126163.06,126163.06,0.0,-139.665
105.0,-275.8071,20160418 20:44:51 EST,20160418 20:44:51 EST,20160418 20:44:51 EST,29806.26,,BTCUSD_localbtcRUB,long,,20160418 20:29:05 EST,closed,20160418 20:29:05 EST,29795.16,,,2.0,2.0,,BTCUSD_localbtcRUB,,22.2,-2.0,USD,94416.69345,298.0071,1996801.82,94416.69345,126185.26,126185.26,0.0,-148.9758
106.0,-456.2571,20160418 21:43:24 EST,20160418 21:43:24 EST,20160418 21:43:24 EST,29885.16,,BTCUSD_localbtcRUB,short,,20160418 20:44:51 EST,closed,20160418 20:44:51 EST,29806.26,,,2.0,2.0,,BTCUSD_localbtcRUB,,-157.8,2.0,USD,93960.43635,298.4571,1996959.62,93960.43635,126027.46,126027.46,0.0,-149.0313
107.0,-308.1882,20160418 22:31:54 EST,20160418 22:31:54 EST,20160418 22:31:54 EST,29880.48,,BTCUSD_localbtcRUB,long,,20160418 21:43:24 EST,closed,20160418 21:43:24 EST,29885.16,,,2.0,2.0,,BTCUSD_localbtcRUB,,-9.36,-2.0,USD,93652.24815,298.8282,1996950.26,93652.24815,126018.1,126018.1,0.0,-149.4258
108.0,-239.19615,20160418 23:00:04 EST,20160418 23:00:04 EST,20160418 23:00:04 EST,29850.75,,BTCUSD_localbtcRUB,short,,20160418 22:31:54 EST,closed,20160418 22:31:54 EST,29880.48,,,2.0,2.0,,BTCUSD_localbtcRUB,,59.46,2.0,USD,93413.052,298.65615,1996890.8,93413.052,126077.56,126077.56,0.0,-149.4024
109.0,-239.19615,20160418 23:15:00 EST,20160418 23:15:00 EST,20160418 23:15:00 EST,29880.48,,BTCUSD_localbtcRUB,long,,20160418 23:00:04 EST,closed,20160418 23:00:04 EST,29850.75,,,2.0,2.0,,BTCUSD_localbtcRUB,,59.46,-2.0,USD,93173.85585,298.65615,1996950.26,93173.85585,126137.02,126137.02,0.0,-149.25375
110.0,-852.8665,20160419 01:46:23 EST,20160419 01:46:23 EST,20160419 01:46:23 EST,30156.82,,BTCUSD_localbtcRUB,short,,20160418 23:15:00 EST,closed,20160418 23:15:00 EST,29880.48,,,2.0,2.0,,BTCUSD_localbtcRUB,,-552.68,2.0,USD,92320.98935,300.1865,1997502.94,92320.98935,125584.34,125584.34,0.0,-149.4024
111.0,-337.33855,20160419 02:44:32 EST,20160419 02:44:32 EST,20160419 02:44:32 EST,30138.89,,BTCUSD_localbtcRUB,long,,20160419 01:46:23 EST,closed,20160419 01:46:23 EST,30156.82,,,2.0,2.0,,BTCUSD_localbtcRUB,,-35.86,-2.0,USD,91983.6508,301.47855,1997467.08,91983.6508,125548.48,125548.48,0.0,-150.7841
112.0,768.53925,20160419 03:21:31 EST,20160419 03:21:31 EST,20160419 03:21:31 EST,29605.26,,BTCUSD_localbtcRUB,short,,20160419 02:44:32 EST,closed,20160419 02:44:32 EST,30138.89,,,2.0,2.0,,BTCUSD_localbtcRUB,,1067.26,2.0,USD,92752.19005,298.72075,1996399.82,92752.19005,126615.74,126615.74,0.0,-150.69445
113.0,193.69995,20160419 04:46:29 EST,20160419 04:46:29 EST,20160419 04:46:29 EST,29850.75,,BTCUSD_localbtcRUB,long,,20160419 03:21:31 EST,closed,20160419 03:21:31 EST,29605.26,,,2.0,2.0,,BTCUSD_localbtcRUB,,490.98,-2.0,USD,92945.89,297.28005,1996890.8,92945.89,127106.72,127106.72,0.0,-148.0263
114.0,-514.3257,20160419 05:08:07 EST,20160419 05:08:07 EST,20160419 05:08:07 EST,29958.39,,BTCUSD_localbtcRUB,short,,20160419 04:46:29 EST,closed,20160419 04:46:29 EST,29850.75,,,2.0,2.0,,BTCUSD_localbtcRUB,,-215.28,2.0,USD,92431.5643,299.0457,1997106.08,92431.5643,126891.44,126891.44,0.0,-149.25375
115.0,-976.647,20160419 05:29:39 EST,20160419 05:29:39 EST,20160419 05:29:39 EST,29619.01,,BTCUSD_localbtcRUB,long,,20160419 05:08:07 EST,closed,20160419 05:08:07 EST,29958.39,,,2.0,2.0,,BTCUSD_localbtcRUB,,-678.76,-2.0,USD,91454.9173,297.887,1996427.32,91454.9173,126212.68,126212.68,0.0,-149.79195
116.0,640.28525,20160419 07:17:07 EST,20160419 07:17:07 EST,20160419 07:17:07 EST,29151.94,,BTCUSD_localbtcRUB,short,,20160419 05:29:39 EST,closed,20160419 05:29:39 EST,29619.01,,,2.0,2.0,,BTCUSD_localbtcRUB,,934.14,2.0,USD,92095.20255,293.85475,1995493.18,92095.20255,127146.82,127146.82,0.0,-148.09505
117.0,-602.0611,20160419 08:16:46 EST,20160419 08:16:46 EST,20160419 08:16:46 EST,28996.28,,BTCUSD_localbtcRUB,long,,20160419 07:17:07 EST,closed,20160419 07:17:07 EST,29151.94,,,2.0,2.0,,BTCUSD_localbtcRUB,,-311.32,-2.0,USD,91493.14145,290.7411,1995181.86,91493.14145,126835.5,126835.5,0.0,-145.7597
118.0,-1622.7665,20160419 08:31:53 EST,20160419 08:31:53 EST,20160419 08:31:53 EST,29661.02,,BTCUSD_localbtcRUB,short,,20160419 08:16:46 EST,closed,20160419 08:16:46 EST,28996.28,,,2.0,2.0,,BTCUSD_localbtcRUB,,-1329.48,2.0,USD,89870.37495,293.2865,1996511.34,89870.37495,125506.02,125506.02,0.0,-144.9814
119.0,3059.4985,20160419 08:52:04 EST,20160419 08:52:04 EST,20160419 08:52:04 EST,31343.28,,BTCUSD_localbtcRUB,long,,20160419 08:31:53 EST,closed,20160419 08:31:53 EST,29661.02,,,2.0,2.0,,BTCUSD_localbtcRUB,,3364.52,-2.0,USD,92929.87345,305.0215,1999875.86,92929.87345,128870.54,128870.54,0.0,-148.3051
120.0,6139.2186,20160419 09:31:52 EST,20160419 09:31:52 EST,20160419 09:31:52 EST,28125.0,,BTCUSD_localbtcRUB,short,,20160419 08:52:04 EST,closed,20160419 08:52:04 EST,31343.28,,,2.0,2.0,,BTCUSD_localbtcRUB,,6436.56,2.0,USD,99069.09205,297.3414,1993439.3,99069.09205,135307.1,135307.1,0.0,-156.7164
121.0,1980.6411,20160419 10:15:10 EST,20160419 10:15:10 EST,20160419 10:15:10 EST,29258.78,,BTCUSD_localbtcRUB,long,,20160419 09:31:52 EST,closed,20160419 09:31:52 EST,28125.0,,,2.0,2.0,,BTCUSD_localbtcRUB,,2267.56,-2.0,USD,101049.73315,286.9189,1995706.86,101049.73315,137574.66,137574.66,0.0,-140.625
122.0,-302.48495,20160419 11:01:05 EST,20160419 11:01:05 EST,20160419 11:01:05 EST,29292.11,,BTCUSD_localbtcRUB,long,,20160419 10:39:11 EST,closed,20160419 10:39:11 EST,29296.88,,,2.0,2.0,,BTCUSD_localbtcRUB,,-9.54,-2.0,USD,100747.2482,292.94495,1995697.32,100747.2482,137565.12,137565.12,0.0,-146.4844
123.0,26.5155,20160419 11:24:10 EST,20160419 11:24:10 EST,20160419 11:24:10 EST,29132.79,,BTCUSD_localbtcRUB,short,,20160419 11:01:05 EST,closed,20160419 11:01:05 EST,29292.11,,,2.0,2.0,,BTCUSD_localbtcRUB,,318.64,2.0,USD,100773.7637,292.1245,1995378.68,100773.7637,137883.76,137883.76,0.0,-146.46055
124.0,400.8972,20160419 12:09:43 EST,20160419 12:09:43 EST,20160419 12:09:43 EST,29479.77,,BTCUSD_localbtcRUB,long,,20160419 11:24:10 EST,closed,20160419 11:24:10 EST,29132.79,,,2.0,2.0,,BTCUSD_localbtcRUB,,693.96,-2.0,USD,101174.6609,293.0628,1996072.64,101174.6609,138577.72,138577.72,0.0,-145.66395
125.0,-267.0485,20160419 12:31:09 EST,20160419 12:31:09 EST,20160419 12:31:09 EST,29465.93,,BTCUSD_localbtcRUB,short,,20160419 12:09:43 EST,closed,20160419 12:09:43 EST,29479.77,,,2.0,2.0,,BTCUSD_localbtcRUB,,27.68,2.0,USD,100907.6124,294.7285,1996044.96,100907.6124,138605.4,138605.4,0.0,-147.39885
126.0,-868.40135,20160419 12:54:06 EST,20160419 12:54:06 EST,20160419 12:54:06 EST,29178.34,,BTCUSD_localbtcRUB,long,,20160419 12:31:09 EST,closed,20160419 12:31:09 EST,29465.93,,,2.0,2.0,,BTCUSD_localbtcRUB,,-575.18,-2.0,USD,100039.21105,293.22135,1995469.78,100039.21105,138030.22,138030.22,0.0,-147.32965
127.0,51.65305,20160419 13:42:39 EST,20160419 13:42:39 EST,20160419 13:42:39 EST,29007.05,,BTCUSD_localbtcRUB,short,,20160419 12:54:06 EST,closed,20160419 12:54:06 EST,29178.34,,,2.0,2.0,,BTCUSD_localbtcRUB,,342.58,2.0,USD,100090.8641,290.92695,1995127.2,100090.8641,138372.8,138372.8,0.0,-145.8917
128.0,517.32595,20160419 14:05:21 EST,20160419 14:05:21 EST,20160419 14:05:21 EST,29411.76,,BTCUSD_localbtcRUB,long,,20160419 13:42:39 EST,closed,20160419 13:42:39 EST,29007.05,,,2.0,2.0,,BTCUSD_localbtcRUB,,809.42,-2.0,USD,100608.19005,292.09405,1995936.62,100608.19005,139182.22,139182.22,0.0,-145.03525
129.0,-178.72985,20160419 14:25:13 EST,20160419 14:25:13 EST,20160419 14:25:13 EST,29354.21,,BTCUSD_localbtcRUB,short,,20160419 14:05:21 EST,closed,20160419 14:05:21 EST,29411.76,,,2.0,2.0,,BTCUSD_localbtcRUB,,115.1,2.0,USD,100429.4602,293.82985,1995821.52,100429.4602,139297.32,139297.32,0.0,-147.0588
130.0,-574.29845,20160419 14:49:39 EST,20160419 14:49:39 EST,20160419 14:49:39 EST,29213.48,,BTCUSD_localbtcRUB,long,,20160419 14:25:13 EST,closed,20160419 14:25:13 EST,29354.21,,,2.0,2.0,,BTCUSD_localbtcRUB,,-281.46,-2.0,USD,99855.16175,292.83845,1995540.06,99855.16175,139015.86,139015.86,0.0,-146.77105
131.0,-3.99625,20160419 16:11:33 EST,20160419 16:11:33 EST,20160419 16:11:33 EST,29069.77,,BTCUSD_localbtcRUB,short,,20160419 14:49:39 EST,closed,20160419 14:49:39 EST,29213.48,,,2.0,2.0,,BTCUSD_localbtcRUB,,287.42,2.0,USD,99851.1655,291.41625,1995252.64,99851.1655,139303.28,139303.28,0.0,-146.0674
132.0,268.56065,20160419 16:30:19 EST,20160419 16:30:19 EST,20160419 16:30:19 EST,29350.1,,BTCUSD_localbtcRUB,long,,20160419 16:11:33 EST,closed,20160419 16:11:33 EST,29069.77,,,2.0,2.0,,BTCUSD_localbtcRUB,,560.66,-2.0,USD,100119.72615,292.09935,1995813.3,100119.72615,139863.94,139863.94,0.0,-145.34885
133.0,-293.501,20160419 17:13:27 EST,20160419 17:13:27 EST,20160419 17:13:27 EST,29350.1,,BTCUSD_localbtcRUB,short,,20160419 16:30:19 EST,closed,20160419 16:30:19 EST,29350.1,,,2.0,2.0,,BTCUSD_localbtcRUB,,0.0,2.0,USD,99826.22515,293.501,1995813.3,99826.22515,139863.94,139863.94,0.0,-146.7505
134.0,-1298.88125,20160419 17:54:03 EST,20160419 17:54:03 EST,20160419 17:54:03 EST,28846.15,,BTCUSD_localbtcRUB,long,,20160419 17:13:27 EST,closed,20160419 17:13:27 EST,29350.1,,,2.0,2.0,,BTCUSD_localbtcRUB,,-1007.9,-2.0,USD,98527.3439,290.98125,1994805.4,98527.3439,138856.04,138856.04,0.0,-146.7505
135.0,-1134.8522,20160419 18:18:02 EST,20160419 18:18:02 EST,20160419 18:18:02 EST,29268.29,,BTCUSD_localbtcRUB,short,,20160419 17:54:03 EST,closed,20160419 17:54:03 EST,28846.15,,,2.0,2.0,,BTCUSD_localbtcRUB,,-844.28,2.0,USD,97392.4917,290.5722,1995649.68,97392.4917,138011.76,138011.76,0.0,-144.23075
136.0,121.65865,20160419 18:55:43 EST,20160419 18:55:43 EST,20160419 18:55:43 EST,29475.98,,BTCUSD_localbtcRUB,long,,20160419 18:18:02 EST,closed,20160419 18:18:02 EST,29268.29,,,2.0,2.0,,BTCUSD_localbtcRUB,,415.38,-2.0,USD,97514.15035,293.72135,1996065.06,97514.15035,138427.14,138427.14,0.0,-146.34145
137.0,55.01245,20160419 19:30:29 EST,20160419 19:30:29 EST,20160419 19:30:29 EST,29301.53,,BTCUSD_localbtcRUB,short,,20160419 18:55:43 EST,closed,20160419 18:55:43 EST,29475.98,,,2.0,2.0,,BTCUSD_localbtcRUB,,348.9,2.0,USD,97569.1628,293.88755,1995716.16,97569.1628,138776.04,138776.04,0.0,-147.3799
138.0,-245.1752,20160419 19:49:05 EST,20160419 19:49:05 EST,20160419 19:49:05 EST,29325.51,,BTCUSD_localbtcRUB,long,,20160419 19:30:29 EST,closed,20160419 19:30:29 EST,29301.53,,,2.0,2.0,,BTCUSD_localbtcRUB,,47.96,-2.0,USD,97323.9876,293.1352,1995764.12,97323.9876,138824.0,138824.0,0.0,-146.50765
139.0,-35.75295,20160419 21:56:17 EST,20160419 21:56:17 EST,20160419 21:56:17 EST,29197.08,,BTCUSD_localbtcRUB,short,,20160419 19:49:05 EST,closed,20160419 19:49:05 EST,29325.51,,,2.0,2.0,,BTCUSD_localbtcRUB,,256.86,2.0,USD,97288.23465,292.61295,1995507.26,97288.23465,139080.86,139080.86,0.0,-146.62755
140.0,1914.39945,20160419 22:40:05 EST,20160419 22:40:05 EST,20160419 22:40:05 EST,30303.03,,BTCUSD_localbtcRUB,long,,20160419 21:56:17 EST,closed,20160419 21:56:17 EST,29197.08,,,2.0,2.0,,BTCUSD_localbtcRUB,,2211.9,-2.0,USD,99202.6341,297.50055,1997719.16,99202.6341,141292.76,141292.76,0.0,-145.9854
141.0,514.328,20160420 00:43:59 EST,20160420 00:43:59 EST,20160420 00:43:59 EST,29895.37,,BTCUSD_localbtcRUB,short,,20160419 22:40:05 EST,closed,20160419 22:40:05 EST,30303.03,,,2.0,2.0,,BTCUSD_localbtcRUB,,815.32,2.0,USD,99716.9621,300.992,1996903.84,99716.9621,142108.08,142108.08,0.0,-151.51515
142.0,-90.21685,20160420 01:46:27 EST,20160420 01:46:27 EST,20160420 01:46:27 EST,30000.0,,BTCUSD_localbtcRUB,long,,20160420 00:43:59 EST,closed,20160420 00:43:59 EST,29895.37,,,2.0,2.0,,BTCUSD_localbtcRUB,,209.26,-2.0,USD,99626.74525,299.47685,1997113.1,99626.74525,142317.34,142317.34,0.0,-149.47685
143.0,-300.0,20160420 02:02:25 EST,20160420 02:02:25 EST,20160420 02:02:25 EST,30000.0,,BTCUSD_localbtcRUB,short,,20160420 01:46:27 EST,closed,20160420 01:46:27 EST,30000.0,,,2.0,2.0,,BTCUSD_localbtcRUB,,0.0,2.0,USD,99326.74525,300.0,1997113.1,99326.74525,142317.34,142317.34,0.0,-150.0
144.0,-764.3163,20160420 02:28:13 EST,20160420 02:28:13 EST,20160420 02:28:13 EST,29767.26,,BTCUSD_localbtcRUB,long,,20160420 02:02:25 EST,closed,20160420 02:02:25 EST,30000.0,,,2.0,2.0,,BTCUSD_localbtcRUB,,-465.48,-2.0,USD,98562.42895,298.8363,1996647.62,98562.42895,141851.86,141851.86,0.0,-150.0
145.0,906.51035,20160420 04:00:56 EST,20160420 04:00:56 EST,20160420 04:00:56 EST,29166.67,,BTCUSD_localbtcRUB,short,,20160420 02:28:13 EST,closed,20160420 02:28:13 EST,29767.26,,,2.0,2.0,,BTCUSD_localbtcRUB,,1201.18,2.0,USD,99468.9393,294.66965,1995446.44,99468.9393,143053.04,143053.04,0.0,-148.8363
146.0,-3616.67335,20160420 04:51:55 EST,20160420 04:51:55 EST,20160420 04:51:55 EST,27500.0,,BTCUSD_localbtcRUB,long,,20160420 04:00:56 EST,closed,20160420 04:00:56 EST,29166.67,,,2.0,2.0,,BTCUSD_localbtcRUB,,-3333.34,-2.0,USD,95852.26595,283.33335,1992113.1,95852.26595,139719.7,139719.7,0.0,-145.83335
147.0,-3491.5012,20160420 05:17:41 EST,20160420 05:17:41 EST,20160420 05:17:41 EST,29104.24,,BTCUSD_localbtcRUB,short,,20160420 04:51:55 EST,closed,20160420 04:51:55 EST,27500.0,,,2.0,2.0,,BTCUSD_localbtcRUB,,-3208.48,2.0,USD,92360.76475,283.0212,1995321.58,92360.76475,136511.22,136511.22,0.0,-137.5
148.0,-298.44385,20160420 06:22:30 EST,20160420 06:22:30 EST,20160420 06:22:30 EST,29100.53,,BTCUSD_localbtcRUB,long,,20160420 05:17:41 EST,closed,20160420 05:17:41 EST,29104.24,,,2.0,2.0,,BTCUSD_localbtcRUB,,-7.42000000001,-2.0,USD,92062.3209,291.02385,1995314.16,92062.3209,136503.8,136503.8,0.0,-145.5212
149.0,-125.25195,20160420 06:58:05 EST,20160420 06:58:05 EST,20160420 06:58:05 EST,29017.86,,BTCUSD_localbtcRUB,short,,20160420 06:22:30 EST,closed,20160420 06:22:30 EST,29100.53,,,2.0,2.0,,BTCUSD_localbtcRUB,,165.34,2.0,USD,91937.06895,290.59195,1995148.82,91937.06895,136669.14,136669.14,0.0,-145.50265
150.0,-98.5389,20160420 07:41:24 EST,20160420 07:41:24 EST,20160420 07:41:24 EST,29113.92,,BTCUSD_localbtcRUB,long,,20160420 06:58:05 EST,closed,20160420 06:58:05 EST,29017.86,,,2.0,2.0,,BTCUSD_localbtcRUB,,192.12,-2.0,USD,91838.53005,290.6589,1995340.94,91838.53005,136861.26,136861.26,0.0,-145.0893
151.0,-521.01245,20160420 08:02:21 EST,20160420 08:02:21 EST,20160420 08:02:21 EST,29228.57,,BTCUSD_localbtcRUB,short,,20160420 07:41:24 EST,closed,20160420 07:41:24 EST,29113.92,,,2.0,2.0,,BTCUSD_localbtcRUB,,-229.3,2.0,USD,91317.5176,291.71245,1995570.24,91317.5176,136631.96,136631.96,0.0,-145.5696
152.0,-492.04505,20160420 09:39:10 EST,20160420 09:39:10 EST,20160420 09:39:10 EST,29128.44,,BTCUSD_localbtcRUB,long,,20160420 08:02:21 EST,closed,20160420 08:02:21 EST,29228.57,,,2.0,2.0,,BTCUSD_localbtcRUB,,-200.26,-2.0,USD,90825.47255,291.78505,1995369.98,90825.47255,136431.7,136431.7,0.0,-146.14285
153.0,-490.02,20160420 10:01:03 EST,20160420 10:01:03 EST,20160420 10:01:03 EST,29227.56,,BTCUSD_localbtcRUB,short,,20160420 09:39:10 EST,closed,20160420 09:39:10 EST,29128.44,,,2.0,2.0,,BTCUSD_localbtcRUB,,-198.24,2.0,USD,90335.45255,291.78,1995568.22,90335.45255,136233.46,136233.46,0.0,-145.6422
154.0,364.25895,20160420 10:27:22 EST,20160420 10:27:22 EST,20160420 10:27:22 EST,29556.65,,BTCUSD_localbtcRUB,long,,20160420 10:01:03 EST,closed,20160420 10:01:03 EST,29227.56,,,2.0,2.0,,BTCUSD_localbtcRUB,,658.18,-2.0,USD,90699.7115,293.92105,1996226.4,90699.7115,136891.64,136891.64,0.0,-146.1378
155.0,233.1921,20160420 11:18:49 EST,20160420 11:18:49 EST,20160420 11:18:49 EST,29292.93,,BTCUSD_localbtcRUB,short,,20160420 10:27:22 EST,closed,20160420 10:27:22 EST,29556.65,,,2.0,2.0,,BTCUSD_localbtcRUB,,527.44,2.0,USD,90932.9036,294.2479,1995698.96,90932.9036,137419.08,137419.08,0.0,-147.78325
156.0,-697.77465,20160420 12:31:49 EST,20160420 12:31:49 EST,20160420 12:31:49 EST,29090.0,,BTCUSD_localbtcRUB,long,,20160420 11:18:49 EST,closed,20160420 11:18:49 EST,29292.93,,,2.0,2.0,,BTCUSD_localbtcRUB,,-405.86,-2.0,USD,90235.12895,291.91465,1995293.1,90235.12895,137013.22,137013.22,0.0,-146.46465
157.0,-936.0288,20160420 12:57:21 EST,20160420 12:57:21 EST,20160420 12:57:21 EST,29411.76,,BTCUSD_localbtcRUB,short,,20160420 12:31:49 EST,closed,20160420 12:31:49 EST,29090.0,,,2.0,2.0,,BTCUSD_localbtcRUB,,-643.52,2.0,USD,89299.10015,292.5088,1995936.62,89299.10015,136369.7,136369.7,0.0,-145.45
158.0,-325.479,20160420 13:20:02 EST,20160420 13:20:02 EST,20160420 13:20:02 EST,29396.04,,BTCUSD_localbtcRUB,long,,20160420 12:57:21 EST,closed,20160420 12:57:21 EST,29411.76,,,2.0,2.0,,BTCUSD_localbtcRUB,,-31.44,-2.0,USD,88973.62115,294.039,1995905.18,88973.62115,136338.26,136338.26,0.0,-147.0588
159.0,219.3998,20160420 13:42:22 EST,20160420 13:42:22 EST,20160420 13:42:22 EST,29140.0,,BTCUSD_localbtcRUB,short,,20160420 13:20:02 EST,closed,20160420 13:20:02 EST,29396.04,,,2.0,2.0,,BTCUSD_localbtcRUB,,512.08,2.0,USD,89193.02095,292.6802,1995393.1,89193.02095,136850.34,136850.34,0.0,-146.9802
160.0,1114.69595,20160420 17:19:07 EST,20160420 17:19:07 EST,20160420 17:19:07 EST,29844.81,,BTCUSD_localbtcRUB,long,,20160420 13:42:22 EST,closed,20160420 13:42:22 EST,29140.0,,,2.0,2.0,,BTCUSD_localbtcRUB,,1409.62,-2.0,USD,90307.7169,294.92405,1996802.72,90307.7169,138259.96,138259.96,0.0,-145.7
161.0,395.8433,20160420 17:42:56 EST,20160420 17:42:56 EST,20160420 17:42:56 EST,29498.53,,BTCUSD_localbtcRUB,short,,20160420 17:19:07 EST,closed,20160420 17:19:07 EST,29844.81,,,2.0,2.0,,BTCUSD_localbtcRUB,,692.56,2.0,USD,90703.5602,296.7167,1996110.16,90703.5602,138952.52,138952.52,0.0,-149.22405
162.0,309.08075,20160420 18:00:59 EST,20160420 18:00:59 EST,20160420 18:00:59 EST,29801.32,,BTCUSD_localbtcRUB,long,,20160420 17:42:56 EST,closed,20160420 17:42:56 EST,29498.53,,,2.0,2.0,,BTCUSD_localbtcRUB,,605.58,-2.0,USD,91012.64095,296.49925,1996715.74,91012.64095,139558.1,139558.1,0.0,-147.49265
163.0,-1790.3347,20160420 18:22:42 EST,20160420 18:22:42 EST,20160420 18:22:42 EST,30545.62,,BTCUSD_localbtcRUB,short,,20160420 18:00:59 EST,closed,20160420 18:00:59 EST,29801.32,,,2.0,2.0,,BTCUSD_localbtcRUB,,-1488.6,2.0,USD,89222.30625,301.7347,1998204.34,89222.30625,138069.5,138069.5,0.0,-149.0066
164.0,-1796.9581,20160420 18:41:07 EST,20160420 18:41:07 EST,20160420 18:41:07 EST,29798.0,,BTCUSD_localbtcRUB,long,,20160420 18:22:42 EST,closed,20160420 18:22:42 EST,30545.62,,,2.0,2.0,,BTCUSD_localbtcRUB,,-1495.24,-2.0,USD,87425.34815,301.7181,1996709.1,87425.34815,136574.26,136574.26,0.0,-152.7281
165.0,-1402.75505,20160420 19:19:04 EST,20160420 19:19:04 EST,20160420 19:19:04 EST,30349.01,,BTCUSD_localbtcRUB,short,,20160420 18:41:07 EST,closed,20160420 18:41:07 EST,29798.0,,,2.0,2.0,,BTCUSD_localbtcRUB,,-1102.02,2.0,USD,86022.5931,300.73505,1997811.12,86022.5931,135472.24,135472.24,0.0,-148.99
166.0,-1209.04055,20160420 23:40:22 EST,20160420 23:40:22 EST,20160420 23:40:22 EST,29895.1,,BTCUSD_localbtcRUB,long,,20160420 19:19:04 EST,closed,20160420 19:19:04 EST,30349.01,,,2.0,2.0,,BTCUSD_localbtcRUB,,-907.82,-2.0,USD,84813.55255,301.22055,1996903.3,84813.55255,134564.42,134564.42,0.0,-151.74505
167.0,-309.43715,20160420 23:59:03 EST,20160420 23:59:03 EST,20160420 23:59:03 EST,29900.33,,BTCUSD_localbtcRUB,short,,20160420 23:40:22 EST,closed,20160420 23:40:22 EST,29895.1,,,2.0,2.0,,BTCUSD_localbtcRUB,,-10.46,2.0,USD,84504.1154,298.97715,1996913.76,84504.1154,134553.96,134553.96,0.0,-149.4755
168.0,-299.0033,20160421 01:39:39 EST,20160421 01:39:39 EST,20160421 01:39:39 EST,29900.33,,BTCUSD_localbtcRUB,long,,20160420 23:59:03 EST,closed,20160420 23:59:03 EST,29900.33,,,2.0,2.0,,BTCUSD_localbtcRUB,,0.0,-2.0,USD,84205.1121,299.0033,1996913.76,84205.1121,134553.96,134553.96,0.0,-149.50165
169.0,363.5289,20160421 02:25:13 EST,20160421 02:25:13 EST,20160421 02:25:13 EST,29569.89,,BTCUSD_localbtcRUB,short,,20160421 01:39:39 EST,closed,20160421 01:39:39 EST,29900.33,,,2.0,2.0,,BTCUSD_localbtcRUB,,660.88,2.0,USD,84568.641,297.3511,1996252.88,84568.641,135214.84,135214.84,0.0,-149.50165
170.0,-630.24045,20160421 04:27:15 EST,20160421 04:27:15 EST,20160421 04:27:15 EST,29402.2,,BTCUSD_localbtcRUB,long,,20160421 02:25:13 EST,closed,20160421 02:25:13 EST,29569.89,,,2.0,2.0,,BTCUSD_localbtcRUB,,-335.38,-2.0,USD,83938.40055,294.86045,1995917.5,83938.40055,134879.46,134879.46,0.0,-147.84945
171.0,-1136.4027,20160421 04:51:03 EST,20160421 04:51:03 EST,20160421 04:51:03 EST,29822.34,,BTCUSD_localbtcRUB,short,,20160421 04:27:15 EST,closed,20160421 04:27:15 EST,29402.2,,,2.0,2.0,,BTCUSD_localbtcRUB,,-840.28,2.0,USD,82801.99785,296.1227,1996757.78,82801.99785,134039.18,134039.18,0.0,-147.011
172.0,-1545.6171,20160421 08:26:37 EST,20160421 08:26:37 EST,20160421 08:26:37 EST,29197.08,,BTCUSD_localbtcRUB,long,,20160421 04:51:03 EST,closed,20160421 04:51:03 EST,29822.34,,,2.0,2.0,,BTCUSD_localbtcRUB,,-1250.52,-2.0,USD,81256.38075,295.0971,1995507.26,81256.38075,132788.66,132788.66,0.0,-149.1117
173.0,-98.38805,20160421 09:19:05 EST,20160421 09:19:05 EST,20160421 09:19:05 EST,29100.53,,BTCUSD_localbtcRUB,short,,20160421 08:26:37 EST,closed,20160421 08:26:37 EST,29197.08,,,2.0,2.0,,BTCUSD_localbtcRUB,,193.1,2.0,USD,81157.9927,291.48805,1995314.16,81157.9927,132981.76,132981.76,0.0,-145.9854
174.0,-391.81265,20160421 09:44:51 EST,20160421 09:44:51 EST,20160421 09:44:51 EST,29050.0,,BTCUSD_localbtcRUB,long,,20160421 09:19:05 EST,closed,20160421 09:19:05 EST,29100.53,,,2.0,2.0,,BTCUSD_localbtcRUB,,-101.06,-2.0,USD,80766.18005,290.75265,1995213.1,80766.18005,132880.7,132880.7,0.0,-145.50265
175.0,-1015.8288,20160421 10:38:04 EST,20160421 10:38:04 EST,20160421 10:38:04 EST,29411.76,,BTCUSD_localbtcRUB,short,,20160421 09:44:51 EST,closed,20160421 09:44:51 EST,29050.0,,,2.0,2.0,,BTCUSD_localbtcRUB,,-723.52,2.0,USD,79750.35125,292.3088,1995936.62,79750.35125,132157.18,132157.18,0.0,-145.25
176.0,140.53305,20160421 16:57:24 EST,20160421 16:57:24 EST,20160421 16:57:24 EST,29629.63,,BTCUSD_localbtcRUB,long,,20160421 10:38:04 EST,closed,20160421 10:38:04 EST,29411.76,,,2.0,2.0,,BTCUSD_localbtcRUB,,435.74,-2.0,USD,79890.8843,295.20695,1996372.36,79890.8843,132592.92,132592.92,0.0,-147.0588
177.0,-179.6053,20160421 17:19:37 EST,20160421 17:19:37 EST,20160421 17:19:37 EST,29571.43,,BTCUSD_localbtcRUB,short,,20160421 16:57:24 EST,closed,20160421 16:57:24 EST,29629.63,,,2.0,2.0,,BTCUSD_localbtcRUB,,116.4,2.0,USD,79711.279,296.0053,1996255.96,79711.279,132709.32,132709.32,0.0,-148.14815
178.0,788.3288,20160421 18:49:48 EST,20160421 18:49:48 EST,20160421 18:49:48 EST,30114.81,,BTCUSD_localbtcRUB,long,,20160421 17:19:37 EST,closed,20160421 17:19:37 EST,29571.43,,,2.0,2.0,,BTCUSD_localbtcRUB,,1086.76,-2.0,USD,80499.6078,298.4312,1997342.72,80499.6078,133796.08,133796.08,0.0,-147.85715
179.0,-863.20975,20160421 19:13:03 EST,20160421 19:13:03 EST,20160421 19:13:03 EST,30395.14,,BTCUSD_localbtcRUB,short,,20160421 18:49:48 EST,closed,20160421 18:49:48 EST,30114.81,,,2.0,2.0,,BTCUSD_localbtcRUB,,-560.66,2.0,USD,79636.39805,302.54975,1997903.38,79636.39805,133235.42,133235.42,0.0,-150.57405
180.0,-367.3525,20160421 20:22:13 EST,20160421 20:22:13 EST,20160421 20:22:13 EST,30363.36,,BTCUSD_localbtcRUB,long,,20160421 19:13:03 EST,closed,20160421 19:13:03 EST,30395.14,,,2.0,2.0,,BTCUSD_localbtcRUB,,-63.56,-2.0,USD,79269.04555,303.7925,1997839.82,79269.04555,133171.86,133171.86,0.0,-151.9757
181.0,-514.319,20160421 21:26:01 EST,20160421 21:26:01 EST,20160421 21:26:01 EST,30468.44,,BTCUSD_localbtcRUB,short,,20160421 20:22:13 EST,closed,20160421 20:22:13 EST,30363.36,,,2.0,2.0,,BTCUSD_localbtcRUB,,-210.16,2.0,USD,78754.72655,304.159,1998049.98,78754.72655,132961.7,132961.7,0.0,-151.8168
182.0,-5528.4722,20160422 00:11:05 EST,20160422 00:11:05 EST,20160422 00:11:05 EST,27850.0,,BTCUSD_localbtcRUB,long,,20160421 21:26:01 EST,closed,20160421 21:26:01 EST,30468.44,,,2.0,2.0,,BTCUSD_localbtcRUB,,-5236.88,-2.0,USD,73226.25435,291.5922,1992813.1,73226.25435,127724.82,127724.82,0.0,-152.3422
183.0,-4388.75,20160422 01:24:04 EST,20160422 01:24:04 EST,20160422 01:24:04 EST,29900.0,,BTCUSD_localbtcRUB,short,,20160422 00:11:05 EST,closed,20160422 00:11:05 EST,27850.0,,,2.0,2.0,,BTCUSD_localbtcRUB,,-4100.0,2.0,USD,68837.50435,288.75,1996913.1,68837.50435,123624.82,123624.82,0.0,-139.25
184.0,-3699.49745,20160422 01:49:16 EST,20160422 01:49:16 EST,20160422 01:49:16 EST,28195.49,,BTCUSD_localbtcRUB,long,,20160422 01:24:04 EST,closed,20160422 01:24:04 EST,29900.0,,,2.0,2.0,,BTCUSD_localbtcRUB,,-3409.02,-2.0,USD,65138.0069,290.47745,1993504.08,65138.0069,120215.8,120215.8,0.0,-149.5
185.0,-3600.7512,20160422 02:48:34 EST,20160422 02:48:34 EST,20160422 02:48:34 EST,29850.75,,BTCUSD_localbtcRUB,short,,20160422 01:49:16 EST,closed,20160422 01:49:16 EST,28195.49,,,2.0,2.0,,BTCUSD_localbtcRUB,,-3310.52,2.0,USD,61537.2557,290.2312,1996814.6,61537.2557,116905.28,116905.28,0.0,-140.97745
186.0,239.60385,20160422 03:46:58 EST,20160422 03:46:58 EST,20160422 03:46:58 EST,30120.48,,BTCUSD_localbtcRUB,long,,20160422 02:48:34 EST,closed,20160422 02:48:34 EST,29850.75,,,2.0,2.0,,BTCUSD_localbtcRUB,,539.46,-2.0,USD,61776.85955,299.85615,1997354.06,61776.85955,117444.74,117444.74,0.0,-149.25375
187.0,945.80495,20160422 04:41:16 EST,20160422 04:41:16 EST,20160422 04:41:16 EST,29498.53,,BTCUSD_localbtcRUB,short,,20160422 03:46:58 EST,closed,20160422 03:46:58 EST,30120.48,,,2.0,2.0,,BTCUSD_localbtcRUB,,1243.9,2.0,USD,62722.6645,298.09505,1996110.16,62722.6645,118688.64,118688.64,0.0,-150.6024
188.0,-292.05265,20160422 05:10:17 EST,20160422 05:10:17 EST,20160422 05:10:17 EST,29500.0,,BTCUSD_localbtcRUB,long,,20160422 04:41:16 EST,closed,20160422 04:41:16 EST,29498.53,,,2.0,2.0,,BTCUSD_localbtcRUB,,2.94,-2.0,USD,62430.61185,294.99265,1996113.1,62430.61185,118691.58,118691.58,0.0,-147.49265
189.0,-147.5,,,,0.0,,BTCUSD_localbtcRUB,short,,20160422 05:10:17 EST,open,20160422 05:10:17 EST,29500.0,,,0.0,2.0,,BTCUSD_localbtcRUB,,0.0,-2.0,USD,62283.11185,147.5,1937113.1,62135.61185,118691.58,118691.58,,
