trade_id,PL,closeVWAP_timestamp,closedWhen,closedWhenUnixTimeStamp,closing_price_VWAP,expir,instrument,long_or_short,markToMarket_time,openVWAP_timestamp,open_or_closed,openedWhen,opening_price_VWAP,ptValue,putcall,quant_closed,quant_opened,strike,symbol,symbol_description,PurePL,qty,balance,commission,margin_available,purebalance
1.0,-6.7,20160323 05:44:53 EST,20160323 05:44:53 EST,20160323 05:44:53 EST,0.75902,,AUDUSD,long,,20160323 05:41:18 EST,closed,20160323 05:41:18 EST,0.75929,,,1.0,1.0,,AUDUSD,,-2.7,-1.0,19993.3,4.0,399997.3,19997.3
2.0,7.3,20160323 06:21:07 EST,20160323 06:21:07 EST,20160323 06:21:07 EST,0.75789,,AUDUSD,short,,20160323 05:44:53 EST,closed,20160323 05:44:53 EST,0.75902,,,1.0,1.0,,AUDUSD,,11.3,1.0,20000.6,4.0,399986.0,20008.6
3.0,-2.4,20160323 06:31:59 EST,20160323 06:31:59 EST,20160323 06:31:59 EST,0.75805,,AUDUSD,long,,20160323 06:21:07 EST,closed,20160323 06:21:07 EST,0.75789,,,1.0,1.0,,AUDUSD,,1.6,-1.0,19998.2,4.0,399987.6,20010.2
4.0,-15.8,20160323 06:55:41 EST,20160323 06:55:41 EST,20160323 06:55:41 EST,0.75923,,AUDUSD,short,,20160323 06:31:59 EST,closed,20160323 06:31:59 EST,0.75805,,,1.0,1.0,,AUDUSD,,-11.8,1.0,19982.4,4.0,399999.4,19998.4
5.0,-8.0,20160323 07:10:35 EST,20160323 07:10:35 EST,20160323 07:10:35 EST,0.75883,,AUDUSD,long,,20160323 06:55:41 EST,closed,20160323 06:55:41 EST,0.75923,,,1.0,1.0,,AUDUSD,,-4.0,-1.0,19974.4,4.0,399995.4,19994.4
6.0,-14.0,20160323 07:36:08 EST,20160323 07:36:08 EST,20160323 07:36:08 EST,0.75983,,AUDUSD,short,,20160323 07:10:35 EST,closed,20160323 07:10:35 EST,0.75883,,,1.0,1.0,,AUDUSD,,-10.0,1.0,19960.4,4.0,400005.4,19984.4
7.0,-10.0,20160323 07:58:48 EST,20160323 07:58:48 EST,20160323 07:58:48 EST,0.75923,,AUDUSD,long,,20160323 07:36:08 EST,closed,20160323 07:36:08 EST,0.75983,,,1.0,1.0,,AUDUSD,,-6.0,-1.0,19950.4,4.0,399999.4,19978.4
8.0,3.7,20160323 08:12:38 EST,20160323 08:12:38 EST,20160323 08:12:38 EST,0.75846,,AUDUSD,short,,20160323 07:58:48 EST,closed,20160323 07:58:48 EST,0.75923,,,1.0,1.0,,AUDUSD,,7.7,1.0,19954.1,4.0,399991.7,19986.1
9.0,-9.9,20160323 08:26:48 EST,20160323 08:26:48 EST,20160323 08:26:48 EST,0.75787,,AUDUSD,long,,20160323 08:12:38 EST,closed,20160323 08:12:38 EST,0.75846,,,1.0,1.0,,AUDUSD,,-5.9,-1.0,19944.2,4.0,399985.8,19980.2
10.0,40.0,20160323 12:06:30 EST,20160323 12:06:30 EST,20160323 12:06:30 EST,0.75347,,AUDUSD,short,,20160323 08:26:48 EST,closed,20160323 08:26:48 EST,0.75787,,,1.0,1.0,,AUDUSD,,44.0,1.0,19984.2,4.0,399941.8,20024.2
11.0,-14.3,20160323 12:33:26 EST,20160323 12:33:26 EST,20160323 12:33:26 EST,0.75244,,AUDUSD,long,,20160323 12:06:30 EST,closed,20160323 12:06:30 EST,0.75347,,,1.0,1.0,,AUDUSD,,-10.3,-1.0,19969.9,4.0,399931.5,20013.9
12.0,-13.4,20160323 12:58:32 EST,20160323 12:58:32 EST,20160323 12:58:32 EST,0.75338,,AUDUSD,short,,20160323 12:33:26 EST,closed,20160323 12:33:26 EST,0.75244,,,1.0,1.0,,AUDUSD,,-9.4,1.0,19956.5,4.0,399940.9,20004.5
13.0,-3.1,20160323 13:51:15 EST,20160323 13:51:15 EST,20160323 13:51:15 EST,0.75347,,AUDUSD,long,,20160323 12:58:32 EST,closed,20160323 12:58:32 EST,0.75338,,,1.0,1.0,,AUDUSD,,0.899999999999,-1.0,19953.4,4.0,399941.8,20005.4
14.0,-10.3,20160323 14:21:36 EST,20160323 14:21:36 EST,20160323 14:21:36 EST,0.7541,,AUDUSD,short,,20160323 13:51:15 EST,closed,20160323 13:51:15 EST,0.75347,,,1.0,1.0,,AUDUSD,,-6.3,1.0,19943.1,4.0,399948.1,19999.1
15.0,-19.5,20160323 15:21:02 EST,20160323 15:21:02 EST,20160323 15:21:02 EST,0.75255,,AUDUSD,long,,20160323 14:21:36 EST,closed,20160323 14:21:36 EST,0.7541,,,1.0,1.0,,AUDUSD,,-15.5,-1.0,19923.6,4.0,399932.6,19983.6
16.0,-14.5,20160323 18:18:58 EST,20160323 18:18:58 EST,20160323 18:18:58 EST,0.7536,,AUDUSD,short,,20160323 15:21:02 EST,closed,20160323 15:21:02 EST,0.75255,,,1.0,1.0,,AUDUSD,,-10.5,1.0,19909.1,4.0,399943.1,19973.1
17.0,-30.0,20160323 20:46:41 EST,20160323 20:46:41 EST,20160323 20:46:41 EST,0.751,,AUDUSD,long,,20160323 18:18:58 EST,closed,20160323 18:18:58 EST,0.7536,,,1.0,1.0,,AUDUSD,,-26.0,-1.0,19879.1,4.0,399917.1,19947.1
18.0,11.0,20160323 21:19:58 EST,20160323 21:19:58 EST,20160323 21:19:58 EST,0.7495,,AUDUSD,short,,20160323 20:46:41 EST,closed,20160323 20:46:41 EST,0.751,,,1.0,1.0,,AUDUSD,,15.0,1.0,19890.1,4.0,399902.1,19962.1
19.0,19.4,20160323 22:23:01 EST,20160323 22:23:01 EST,20160323 22:23:01 EST,0.75184,,AUDUSD,long,,20160323 21:19:58 EST,closed,20160323 21:19:58 EST,0.7495,,,1.0,1.0,,AUDUSD,,23.4,-1.0,19909.5,4.0,399925.5,19985.5
20.0,9.6,20160324 00:05:03 EST,20160324 00:05:03 EST,20160324 00:05:03 EST,0.75048,,AUDUSD,short,,20160323 22:23:01 EST,closed,20160323 22:23:01 EST,0.75184,,,1.0,1.0,,AUDUSD,,13.6,1.0,19919.1,4.0,399911.9,19999.1
21.0,-12.0,20160324 00:36:16 EST,20160324 00:36:16 EST,20160324 00:36:16 EST,0.74968,,AUDUSD,long,,20160324 00:05:03 EST,closed,20160324 00:05:03 EST,0.75048,,,1.0,1.0,,AUDUSD,,-8.0,-1.0,19907.1,4.0,399903.9,19991.1
22.0,-1.7,20160324 01:02:21 EST,20160324 01:02:21 EST,20160324 01:02:21 EST,0.74945,,AUDUSD,short,,20160324 00:36:16 EST,closed,20160324 00:36:16 EST,0.74968,,,1.0,1.0,,AUDUSD,,2.3,1.0,19905.4,4.0,399901.6,19993.4
23.0,-2.4,20160324 01:28:01 EST,20160324 01:28:01 EST,20160324 01:28:01 EST,0.74961,,AUDUSD,long,,20160324 01:02:21 EST,closed,20160324 01:02:21 EST,0.74945,,,1.0,1.0,,AUDUSD,,1.6,-1.0,19903.0,4.0,399903.2,19995.0
24.0,-6.5,20160324 01:54:31 EST,20160324 01:54:31 EST,20160324 01:54:31 EST,0.74986,,AUDUSD,short,,20160324 01:28:01 EST,closed,20160324 01:28:01 EST,0.74961,,,1.0,1.0,,AUDUSD,,-2.5,1.0,19896.5,4.0,399905.7,19992.5
25.0,-6.5,20160324 02:17:02 EST,20160324 02:17:02 EST,20160324 02:17:02 EST,0.74961,,AUDUSD,long,,20160324 01:54:31 EST,closed,20160324 01:54:31 EST,0.74986,,,1.0,1.0,,AUDUSD,,-2.5,-1.0,19890.0,4.0,399903.2,19990.0
26.0,-8.5,20160324 02:34:58 EST,20160324 02:34:58 EST,20160324 02:34:58 EST,0.75006,,AUDUSD,short,,20160324 02:17:02 EST,closed,20160324 02:17:02 EST,0.74961,,,1.0,1.0,,AUDUSD,,-4.5,1.0,19881.5,4.0,399907.7,19985.5
27.0,-27.0,20160324 03:27:27 EST,20160324 03:27:27 EST,20160324 03:27:27 EST,0.74776,,AUDUSD,long,,20160324 02:34:58 EST,closed,20160324 02:34:58 EST,0.75006,,,1.0,1.0,,AUDUSD,,-23.0,-1.0,19854.5,4.0,399884.7,19962.5
28.0,-29.0,20160324 04:17:08 EST,20160324 04:17:08 EST,20160324 04:17:08 EST,0.75026,,AUDUSD,short,,20160324 03:27:27 EST,closed,20160324 03:27:27 EST,0.74776,,,1.0,1.0,,AUDUSD,,-25.0,1.0,19825.5,4.0,399909.7,19937.5
29.0,-18.8,20160324 05:12:05 EST,20160324 05:12:05 EST,20160324 05:12:05 EST,0.74878,,AUDUSD,long,,20160324 04:17:08 EST,closed,20160324 04:17:08 EST,0.75026,,,1.0,1.0,,AUDUSD,,-14.8,-1.0,19806.7,4.0,399894.9,19922.7
30.0,-10.1,20160324 05:37:14 EST,20160324 05:37:14 EST,20160324 05:37:14 EST,0.74939,,AUDUSD,short,,20160324 05:12:05 EST,closed,20160324 05:12:05 EST,0.74878,,,1.0,1.0,,AUDUSD,,-6.1,1.0,19796.6,4.0,399901.0,19916.6
31.0,-1.8,20160324 06:03:32 EST,20160324 06:03:32 EST,20160324 06:03:32 EST,0.74961,,AUDUSD,long,,20160324 05:37:14 EST,closed,20160324 05:37:14 EST,0.74939,,,1.0,1.0,,AUDUSD,,2.2,-1.0,19794.8,4.0,399903.2,19918.8
32.0,-16.3,20160324 07:02:41 EST,20160324 07:02:41 EST,20160324 07:02:41 EST,0.75084,,AUDUSD,short,,20160324 06:03:32 EST,closed,20160324 06:03:32 EST,0.74961,,,1.0,1.0,,AUDUSD,,-12.3,1.0,19778.5,4.0,399915.5,19906.5
33.0,-9.2,20160324 07:29:27 EST,20160324 07:29:27 EST,20160324 07:29:27 EST,0.75032,,AUDUSD,long,,20160324 07:02:41 EST,closed,20160324 07:02:41 EST,0.75084,,,1.0,1.0,,AUDUSD,,-5.2,-1.0,19769.3,4.0,399910.3,19901.3
34.0,-8.0,20160324 09:15:11 EST,20160324 09:15:11 EST,20160324 09:15:11 EST,0.75072,,AUDUSD,short,,20160324 07:29:27 EST,closed,20160324 07:29:27 EST,0.75032,,,1.0,1.0,,AUDUSD,,-4.0,1.0,19761.3,4.0,399914.3,19897.3
35.0,1.9,20160324 09:41:49 EST,20160324 09:41:49 EST,20160324 09:41:49 EST,0.75131,,AUDUSD,long,,20160324 09:15:11 EST,closed,20160324 09:15:11 EST,0.75072,,,1.0,1.0,,AUDUSD,,5.9,-1.0,19763.2,4.0,399920.2,19903.2
36.0,-10.3,20160324 10:56:01 EST,20160324 10:56:01 EST,20160324 10:56:01 EST,0.75194,,AUDUSD,short,,20160324 09:41:49 EST,closed,20160324 09:41:49 EST,0.75131,,,1.0,1.0,,AUDUSD,,-6.3,1.0,19752.9,4.0,399926.5,19896.9
37.0,-11.0,20160324 11:46:10 EST,20160324 11:46:10 EST,20160324 11:46:10 EST,0.75124,,AUDUSD,long,,20160324 10:56:01 EST,closed,20160324 10:56:01 EST,0.75194,,,1.0,1.0,,AUDUSD,,-7.0,-1.0,19741.9,4.0,399919.5,19889.9
38.0,-12.2,20160324 13:06:31 EST,20160324 13:06:31 EST,20160324 13:06:31 EST,0.75206,,AUDUSD,short,,20160324 11:46:10 EST,closed,20160324 11:46:10 EST,0.75124,,,1.0,1.0,,AUDUSD,,-8.2,1.0,19729.7,4.0,399927.7,19881.7
39.0,-1.1,20160324 13:35:07 EST,20160324 13:35:07 EST,20160324 13:35:07 EST,0.75235,,AUDUSD,long,,20160324 13:06:31 EST,closed,20160324 13:06:31 EST,0.75206,,,1.0,1.0,,AUDUSD,,2.9,-1.0,19728.6,4.0,399930.6,19884.6
40.0,-14.8,20160324 14:01:24 EST,20160324 14:01:24 EST,20160324 14:01:24 EST,0.75343,,AUDUSD,short,,20160324 13:35:07 EST,closed,20160324 13:35:07 EST,0.75235,,,1.0,1.0,,AUDUSD,,-10.8,1.0,19713.8,4.0,399941.4,19873.8
41.0,-8.2,20160324 14:49:33 EST,20160324 14:49:33 EST,20160324 14:49:33 EST,0.75301,,AUDUSD,long,,20160324 14:01:24 EST,closed,20160324 14:01:24 EST,0.75343,,,1.0,1.0,,AUDUSD,,-4.2,-1.0,19705.6,4.0,399937.2,19869.6
42.0,-4.5,20160324 15:18:59 EST,20160324 15:18:59 EST,20160324 15:18:59 EST,0.75306,,AUDUSD,short,,20160324 14:49:33 EST,closed,20160324 14:49:33 EST,0.75301,,,1.0,1.0,,AUDUSD,,-0.499999999999,1.0,19701.1,4.0,399937.7,19869.1
43.0,-1.2,20160324 15:43:59 EST,20160324 15:43:59 EST,20160324 15:43:59 EST,0.75334,,AUDUSD,long,,20160324 15:18:59 EST,closed,20160324 15:18:59 EST,0.75306,,,1.0,1.0,,AUDUSD,,2.8,-1.0,19699.9,4.0,399940.5,19871.9
44.0,-1.1,20160324 16:11:15 EST,20160324 16:11:15 EST,20160324 16:11:15 EST,0.75305,,AUDUSD,short,,20160324 15:43:59 EST,closed,20160324 15:43:59 EST,0.75334,,,1.0,1.0,,AUDUSD,,2.9,1.0,19698.8,4.0,399937.6,19874.8
45.0,-10.3,20160324 16:42:17 EST,20160324 16:42:17 EST,20160324 16:42:17 EST,0.75242,,AUDUSD,long,,20160324 16:11:15 EST,closed,20160324 16:11:15 EST,0.75305,,,1.0,1.0,,AUDUSD,,-6.3,-1.0,19688.5,4.0,399931.3,19868.5
46.0,-7.4,20160324 17:15:30 EST,20160324 17:15:30 EST,20160324 17:15:30 EST,0.75276,,AUDUSD,short,,20160324 16:42:17 EST,closed,20160324 16:42:17 EST,0.75242,,,1.0,1.0,,AUDUSD,,-3.4,1.0,19681.1,4.0,399934.7,19865.1
47.0,-4.1,20160324 19:15:59 EST,20160324 19:15:59 EST,20160324 19:15:59 EST,0.75275,,AUDUSD,long,,20160324 17:15:30 EST,closed,20160324 17:15:30 EST,0.75276,,,1.0,1.0,,AUDUSD,,-0.0999999999995,-1.0,19677.0,4.0,399934.6,19865.0
48.0,-9.1,20160324 20:08:23 EST,20160324 20:08:23 EST,20160324 20:08:23 EST,0.75326,,AUDUSD,short,,20160324 19:15:59 EST,closed,20160324 19:15:59 EST,0.75275,,,1.0,1.0,,AUDUSD,,-5.1,1.0,19667.9,4.0,399939.7,19859.9
49.0,-9.5,20160324 20:37:10 EST,20160324 20:37:10 EST,20160324 20:37:10 EST,0.75271,,AUDUSD,long,,20160324 20:08:23 EST,closed,20160324 20:08:23 EST,0.75326,,,1.0,1.0,,AUDUSD,,-5.5,-1.0,19658.4,4.0,399934.2,19854.4
50.0,7.7,20160324 22:23:33 EST,20160324 22:23:33 EST,20160324 22:23:33 EST,0.75154,,AUDUSD,short,,20160324 20:37:10 EST,closed,20160324 20:37:10 EST,0.75271,,,1.0,1.0,,AUDUSD,,11.7,1.0,19666.1,4.0,399922.5,19866.1
51.0,-2.8,20160324 23:48:19 EST,20160324 23:48:19 EST,20160324 23:48:19 EST,0.75166,,AUDUSD,long,,20160324 22:23:33 EST,closed,20160324 22:23:33 EST,0.75154,,,1.0,1.0,,AUDUSD,,1.2,-1.0,19663.3,4.0,399923.7,19867.3
52.0,-6.8,20160325 00:31:10 EST,20160325 00:31:10 EST,20160325 00:31:10 EST,0.75194,,AUDUSD,short,,20160324 23:48:19 EST,closed,20160324 23:48:19 EST,0.75166,,,1.0,1.0,,AUDUSD,,-2.8,1.0,19656.5,4.0,399926.5,19864.5
53.0,3.3,20160325 04:06:54 EST,20160325 04:06:54 EST,20160325 04:06:54 EST,0.75267,,AUDUSD,long,,20160325 00:31:10 EST,closed,20160325 00:31:10 EST,0.75194,,,1.0,1.0,,AUDUSD,,7.3,-1.0,19659.8,4.0,399933.8,19871.8
54.0,-8.9,20160325 04:22:59 EST,20160325 04:22:59 EST,20160325 04:22:59 EST,0.75316,,AUDUSD,short,,20160325 04:06:54 EST,closed,20160325 04:06:54 EST,0.75267,,,1.0,1.0,,AUDUSD,,-4.9,1.0,19650.9,4.0,399938.7,19866.9
55.0,-6.2,20160325 04:31:17 EST,20160325 04:31:17 EST,20160325 04:31:17 EST,0.75294,,AUDUSD,long,,20160325 04:22:59 EST,closed,20160325 04:22:59 EST,0.75316,,,1.0,1.0,,AUDUSD,,-2.2,-1.0,19644.7,4.0,399936.5,19864.7
56.0,4.4,20160325 08:41:17 EST,20160325 08:41:17 EST,20160325 08:41:17 EST,0.7521,,AUDUSD,short,,20160325 04:31:17 EST,closed,20160325 04:31:17 EST,0.75294,,,1.0,1.0,,AUDUSD,,8.4,1.0,19649.1,4.0,399928.1,19873.1
57.0,-7.0,20160325 09:26:40 EST,20160325 09:26:40 EST,20160325 09:26:40 EST,0.7518,,AUDUSD,long,,20160325 08:41:17 EST,closed,20160325 08:41:17 EST,0.7521,,,1.0,1.0,,AUDUSD,,-3.0,-1.0,19642.1,4.0,399925.1,19870.1
58.0,-4.6,20160325 10:11:04 EST,20160325 10:11:04 EST,20160325 10:11:04 EST,0.75186,,AUDUSD,short,,20160325 09:26:40 EST,closed,20160325 09:26:40 EST,0.7518,,,1.0,1.0,,AUDUSD,,-0.599999999999,1.0,19637.5,4.0,399925.7,19869.5
59.0,-5.4,20160325 10:40:44 EST,20160325 10:40:44 EST,20160325 10:40:44 EST,0.75172,,AUDUSD,long,,20160325 10:11:04 EST,closed,20160325 10:11:04 EST,0.75186,,,1.0,1.0,,AUDUSD,,-1.4,-1.0,19632.1,4.0,399924.3,19868.1
60.0,-4.6,20160325 10:57:50 EST,20160325 10:57:50 EST,20160325 10:57:50 EST,0.75178,,AUDUSD,short,,20160325 10:40:44 EST,closed,20160325 10:40:44 EST,0.75172,,,1.0,1.0,,AUDUSD,,-0.600000000001,1.0,19627.5,4.0,399924.9,19867.5
61.0,-9.6,20160325 11:23:59 EST,20160325 11:23:59 EST,20160325 11:23:59 EST,0.75122,,AUDUSD,long,,20160325 10:57:50 EST,closed,20160325 10:57:50 EST,0.75178,,,1.0,1.0,,AUDUSD,,-5.6,-1.0,19617.9,4.0,399919.3,19861.9
62.0,-2.5,20160325 11:43:05 EST,20160325 11:43:05 EST,20160325 11:43:05 EST,0.75107,,AUDUSD,short,,20160325 11:23:59 EST,closed,20160325 11:23:59 EST,0.75122,,,1.0,1.0,,AUDUSD,,1.5,1.0,19615.4,4.0,399917.8,19863.4
63.0,-2.0,20160325 11:57:43 EST,20160325 11:57:43 EST,20160325 11:57:43 EST,0.75127,,AUDUSD,long,,20160325 11:43:05 EST,closed,20160325 11:43:05 EST,0.75107,,,1.0,1.0,,AUDUSD,,2.0,-1.0,19613.4,4.0,399919.8,19865.4
64.0,-4.5,20160325 12:47:31 EST,20160325 12:47:31 EST,20160325 12:47:31 EST,0.75132,,AUDUSD,short,,20160325 11:57:43 EST,closed,20160325 11:57:43 EST,0.75127,,,1.0,1.0,,AUDUSD,,-0.5,1.0,19608.9,4.0,399920.3,19864.9
65.0,-11.8,20160325 13:41:21 EST,20160325 13:41:21 EST,20160325 13:41:21 EST,0.75054,,AUDUSD,long,,20160325 12:47:31 EST,closed,20160325 12:47:31 EST,0.75132,,,1.0,1.0,,AUDUSD,,-7.8,-1.0,19597.1,4.0,399912.5,19857.1
66.0,-7.1,20160325 13:54:57 EST,20160325 13:54:57 EST,20160325 13:54:57 EST,0.75085,,AUDUSD,short,,20160325 13:41:21 EST,closed,20160325 13:41:21 EST,0.75054,,,1.0,1.0,,AUDUSD,,-3.1,1.0,19590.0,4.0,399915.6,19854.0
67.0,-5.0,20160325 14:29:06 EST,20160325 14:29:06 EST,20160325 14:29:06 EST,0.75075,,AUDUSD,long,,20160325 13:54:57 EST,closed,20160325 13:54:57 EST,0.75085,,,1.0,1.0,,AUDUSD,,-1.0,-1.0,19585.0,4.0,399914.6,19853.0
68.0,-3.4,20160325 15:58:40 EST,20160325 15:58:40 EST,20160325 15:58:40 EST,0.75069,,AUDUSD,short,,20160325 14:29:06 EST,closed,20160325 14:29:06 EST,0.75075,,,1.0,1.0,,AUDUSD,,0.600000000001,1.0,19581.6,4.0,399914.0,19853.6
69.0,-7.9,20160325 16:14:16 EST,20160325 16:14:16 EST,20160325 16:14:16 EST,0.7503,,AUDUSD,long,,20160325 15:58:40 EST,closed,20160325 15:58:40 EST,0.75069,,,1.0,1.0,,AUDUSD,,-3.9,-1.0,19573.7,4.0,399910.1,19849.7
70.0,-8.9,20160327 19:00:32 EST,20160327 19:00:32 EST,20160327 19:00:32 EST,0.75079,,AUDUSD,short,,20160325 16:14:16 EST,closed,20160325 16:14:16 EST,0.7503,,,1.0,1.0,,AUDUSD,,-4.9,1.0,19564.8,4.0,399915.0,19844.8
71.0,-6.5,20160327 19:03:42 EST,20160327 19:03:42 EST,20160327 19:03:42 EST,0.75054,,AUDUSD,long,,20160327 19:00:32 EST,closed,20160327 19:00:32 EST,0.75079,,,1.0,1.0,,AUDUSD,,-2.5,-1.0,19558.3,4.0,399912.5,19842.3
72.0,1.2,20160327 20:03:46 EST,20160327 20:03:46 EST,20160327 20:03:46 EST,0.75002,,AUDUSD,short,,20160327 19:03:42 EST,closed,20160327 19:03:42 EST,0.75054,,,1.0,1.0,,AUDUSD,,5.2,1.0,19559.5,4.0,399907.3,19847.5
73.0,4.3,20160327 21:33:43 EST,20160327 21:33:43 EST,20160327 21:33:43 EST,0.75085,,AUDUSD,long,,20160327 20:03:46 EST,closed,20160327 20:03:46 EST,0.75002,,,1.0,1.0,,AUDUSD,,8.3,-1.0,19563.8,4.0,399915.6,19855.8
74.0,-10.5,20160328 00:46:04 EST,20160328 00:46:04 EST,20160328 00:46:04 EST,0.7515,,AUDUSD,short,,20160327 21:33:43 EST,closed,20160327 21:33:43 EST,0.75085,,,1.0,1.0,,AUDUSD,,-6.5,1.0,19553.3,4.0,399922.1,19849.3
75.0,7.2,20160328 02:33:02 EST,20160328 02:33:02 EST,20160328 02:33:02 EST,0.75262,,AUDUSD,long,,20160328 00:46:04 EST,closed,20160328 00:46:04 EST,0.7515,,,1.0,1.0,,AUDUSD,,11.2,-1.0,19560.5,4.0,399933.3,19860.5
76.0,-8.3,20160328 05:43:36 EST,20160328 05:43:36 EST,20160328 05:43:36 EST,0.75305,,AUDUSD,short,,20160328 02:33:02 EST,closed,20160328 02:33:02 EST,0.75262,,,1.0,1.0,,AUDUSD,,-4.3,1.0,19552.2,4.0,399937.6,19856.2
77.0,-3.5,20160328 06:05:11 EST,20160328 06:05:11 EST,20160328 06:05:11 EST,0.7531,,AUDUSD,long,,20160328 05:43:36 EST,closed,20160328 05:43:36 EST,0.75305,,,1.0,1.0,,AUDUSD,,0.5,-1.0,19548.7,4.0,399938.1,19856.7
78.0,-5.3,20160328 06:33:18 EST,20160328 06:33:18 EST,20160328 06:33:18 EST,0.75323,,AUDUSD,short,,20160328 06:05:11 EST,closed,20160328 06:05:11 EST,0.7531,,,1.0,1.0,,AUDUSD,,-1.3,1.0,19543.4,4.0,399939.4,19855.4
79.0,-6.5,20160328 07:09:26 EST,20160328 07:09:26 EST,20160328 07:09:26 EST,0.75298,,AUDUSD,long,,20160328 06:33:18 EST,closed,20160328 06:33:18 EST,0.75323,,,1.0,1.0,,AUDUSD,,-2.5,-1.0,19536.9,4.0,399936.9,19852.9
80.0,-2.9,20160328 07:35:04 EST,20160328 07:35:04 EST,20160328 07:35:04 EST,0.75287,,AUDUSD,short,,20160328 07:09:26 EST,closed,20160328 07:09:26 EST,0.75298,,,1.0,1.0,,AUDUSD,,1.1,1.0,19534.0,4.0,399935.8,19854.0
81.0,11.2,20160328 09:05:38 EST,20160328 09:05:38 EST,20160328 09:05:38 EST,0.75439,,AUDUSD,long,,20160328 07:35:04 EST,closed,20160328 07:35:04 EST,0.75287,,,1.0,1.0,,AUDUSD,,15.2,-1.0,19545.2,4.0,399951.0,19869.2
82.0,-7.3,20160328 10:22:00 EST,20160328 10:22:00 EST,20160328 10:22:00 EST,0.75472,,AUDUSD,short,,20160328 09:05:38 EST,closed,20160328 09:05:38 EST,0.75439,,,1.0,1.0,,AUDUSD,,-3.3,1.0,19537.9,4.0,399954.3,19865.9
83.0,-5.2,20160328 11:07:14 EST,20160328 11:07:14 EST,20160328 11:07:14 EST,0.7546,,AUDUSD,long,,20160328 10:22:00 EST,closed,20160328 10:22:00 EST,0.75472,,,1.0,1.0,,AUDUSD,,-1.2,-1.0,19532.7,4.0,399953.1,19864.7
84.0,1.6,20160328 13:23:22 EST,20160328 13:23:22 EST,20160328 13:23:22 EST,0.75404,,AUDUSD,short,,20160328 11:07:14 EST,closed,20160328 11:07:14 EST,0.7546,,,1.0,1.0,,AUDUSD,,5.6,1.0,19534.3,4.0,399947.5,19870.3
85.0,-6.0,20160328 13:37:27 EST,20160328 13:37:27 EST,20160328 13:37:27 EST,0.75384,,AUDUSD,long,,20160328 13:23:22 EST,closed,20160328 13:23:22 EST,0.75404,,,1.0,1.0,,AUDUSD,,-2.0,-1.0,19528.3,4.0,399945.5,19868.3
86.0,-9.1,20160328 14:33:42 EST,20160328 14:33:42 EST,20160328 14:33:42 EST,0.75435,,AUDUSD,short,,20160328 13:37:27 EST,closed,20160328 13:37:27 EST,0.75384,,,1.0,1.0,,AUDUSD,,-5.1,1.0,19519.2,4.0,399950.6,19863.2
87.0,-7.1,20160328 15:08:18 EST,20160328 15:08:18 EST,20160328 15:08:18 EST,0.75404,,AUDUSD,long,,20160328 14:33:42 EST,closed,20160328 14:33:42 EST,0.75435,,,1.0,1.0,,AUDUSD,,-3.1,-1.0,19512.1,4.0,399947.5,19860.1
88.0,-9.8,20160328 16:18:06 EST,20160328 16:18:06 EST,20160328 16:18:06 EST,0.75462,,AUDUSD,short,,20160328 15:08:18 EST,closed,20160328 15:08:18 EST,0.75404,,,1.0,1.0,,AUDUSD,,-5.8,1.0,19502.3,4.0,399953.3,19854.3
89.0,-8.9,20160328 17:21:48 EST,20160328 17:21:48 EST,20160328 17:21:48 EST,0.75413,,AUDUSD,long,,20160328 16:18:06 EST,closed,20160328 16:18:06 EST,0.75462,,,1.0,1.0,,AUDUSD,,-4.9,-1.0,19493.4,4.0,399948.4,19849.4
90.0,-3.3,20160328 17:39:54 EST,20160328 17:39:54 EST,20160328 17:39:54 EST,0.75406,,AUDUSD,short,,20160328 17:21:48 EST,closed,20160328 17:21:48 EST,0.75413,,,1.0,1.0,,AUDUSD,,0.7,1.0,19490.1,4.0,399947.7,19850.1
91.0,-3.8,20160329 10:11:37 EST,20160329 10:11:37 EST,20160329 10:11:37 EST,0.75408,,AUDUSD,long,,20160328 17:39:54 EST,closed,20160328 17:39:54 EST,0.75406,,,1.0,1.0,,AUDUSD,,0.199999999999,-1.0,19486.3,4.0,399947.9,19850.3
92.0,-22.1,20160329 11:32:06 EST,20160329 11:32:06 EST,20160329 11:32:06 EST,0.75589,,AUDUSD,short,,20160329 10:11:37 EST,closed,20160329 10:11:37 EST,0.75408,,,1.0,1.0,,AUDUSD,,-18.1,1.0,19464.2,4.0,399966.0,19832.2
93.0,38.6,20160329 12:43:49 EST,20160329 12:43:49 EST,20160329 12:43:49 EST,0.76015,,AUDUSD,long,,20160329 11:32:06 EST,closed,20160329 11:32:06 EST,0.75589,,,1.0,1.0,,AUDUSD,,42.6,-1.0,19502.8,4.0,400008.6,19874.8
94.0,-40.7,20160329 15:34:39 EST,20160329 15:34:39 EST,20160329 15:34:39 EST,0.76382,,AUDUSD,short,,20160329 12:43:49 EST,closed,20160329 12:43:49 EST,0.76015,,,1.0,1.0,,AUDUSD,,-36.7,1.0,19462.1,4.0,400045.3,19838.1
95.0,30.5,20160330 16:43:19 EST,20160330 16:43:19 EST,20160330 16:43:19 EST,0.76727,,AUDUSD,long,,20160329 15:34:39 EST,closed,20160329 15:34:39 EST,0.76382,,,1.0,1.0,,AUDUSD,,34.5,-1.0,19492.6,4.0,400079.8,19872.6
96.0,4.0,20160330 20:30:00 EST,20160330 20:30:00 EST,20160330 20:30:00 EST,0.76647,,AUDUSD,short,,20160330 16:43:19 EST,closed,20160330 16:43:19 EST,0.76727,,,1.0,1.0,,AUDUSD,,8.0,1.0,19496.6,4.0,400071.8,19880.6
97.0,-17.5,20160330 21:24:46 EST,20160330 21:24:46 EST,20160330 21:24:46 EST,0.76512,,AUDUSD,long,,20160330 20:30:00 EST,closed,20160330 20:30:00 EST,0.76647,,,1.0,1.0,,AUDUSD,,-13.5,-1.0,19479.1,4.0,400058.3,19867.1
98.0,-47.7,20160331 10:36:19 EST,20160331 10:36:19 EST,20160331 10:36:19 EST,0.76949,,AUDUSD,short,,20160330 21:24:46 EST,closed,20160330 21:24:46 EST,0.76512,,,1.0,1.0,,AUDUSD,,-43.7,1.0,19431.4,4.0,400102.0,19823.4
99.0,-4.4,20160331 13:28:09 EST,20160331 13:28:09 EST,20160331 13:28:09 EST,0.76945,,AUDUSD,long,,20160331 10:36:19 EST,closed,20160331 10:36:19 EST,0.76949,,,1.0,1.0,,AUDUSD,,-0.4,-1.0,19427.0,4.0,400101.6,19823.0
100.0,-4.4,20160331 20:42:43 EST,20160331 20:42:43 EST,20160331 20:42:43 EST,0.76949,,AUDUSD,short,,20160331 13:28:09 EST,closed,20160331 13:28:09 EST,0.76945,,,1.0,1.0,,AUDUSD,,-0.4,1.0,19422.6,4.0,400102.0,19822.6
101.0,-4.4,20160331 23:49:53 EST,20160331 23:49:53 EST,20160331 23:49:53 EST,0.76945,,AUDUSD,long,,20160331 20:42:43 EST,closed,20160331 20:42:43 EST,0.76949,,,1.0,1.0,,AUDUSD,,-0.4,-1.0,19418.2,4.0,400101.6,19822.2
102.0,-4.4,20160401 04:37:52 EST,20160401 04:37:52 EST,20160401 04:37:52 EST,0.76949,,AUDUSD,short,,20160331 23:49:53 EST,closed,20160331 23:49:53 EST,0.76945,,,1.0,1.0,,AUDUSD,,-0.4,1.0,19413.8,4.0,400102.0,19821.8
103.0,-4.4,20160401 10:05:53 EST,20160401 10:05:53 EST,20160401 10:05:53 EST,0.76945,,AUDUSD,long,,20160401 04:37:52 EST,closed,20160401 04:37:52 EST,0.76949,,,1.0,1.0,,AUDUSD,,-0.4,-1.0,19409.4,4.0,400101.6,19821.4
104.0,-4.4,20160401 10:17:59 EST,20160401 10:17:59 EST,20160401 10:17:59 EST,0.76949,,AUDUSD,short,,20160401 10:05:53 EST,closed,20160401 10:05:53 EST,0.76945,,,1.0,1.0,,AUDUSD,,-0.4,1.0,19405.0,4.0,400102.0,19821.0
105.0,-4.4,20160401 10:34:11 EST,20160401 10:34:11 EST,20160401 10:34:11 EST,0.76945,,AUDUSD,long,,20160401 10:17:59 EST,closed,20160401 10:17:59 EST,0.76949,,,1.0,1.0,,AUDUSD,,-0.4,-1.0,19400.6,4.0,400101.6,19820.6
106.0,-4.4,20160401 10:36:14 EST,20160401 10:36:14 EST,20160401 10:36:14 EST,0.76949,,AUDUSD,short,,20160401 10:34:11 EST,closed,20160401 10:34:11 EST,0.76945,,,1.0,1.0,,AUDUSD,,-0.4,1.0,19396.2,4.0,400102.0,19820.2
107.0,-4.4,20160401 10:46:19 EST,20160401 10:46:19 EST,20160401 10:46:19 EST,0.76945,,AUDUSD,long,,20160401 10:36:14 EST,closed,20160401 10:36:14 EST,0.76949,,,1.0,1.0,,AUDUSD,,-0.4,-1.0,19391.8,4.0,400101.6,19819.8
108.0,-4.4,20160401 11:02:56 EST,20160401 11:02:56 EST,20160401 11:02:56 EST,0.76949,,AUDUSD,short,,20160401 10:46:19 EST,closed,20160401 10:46:19 EST,0.76945,,,1.0,1.0,,AUDUSD,,-0.4,1.0,19387.4,4.0,400102.0,19819.4
109.0,-4.4,20160401 11:05:01 EST,20160401 11:05:01 EST,20160401 11:05:01 EST,0.76945,,AUDUSD,long,,20160401 11:02:56 EST,closed,20160401 11:02:56 EST,0.76949,,,1.0,1.0,,AUDUSD,,-0.4,-1.0,19383.0,4.0,400101.6,19819.0
110.0,-4.4,20160401 14:44:00 EST,20160401 14:44:00 EST,20160401 14:44:00 EST,0.76949,,AUDUSD,short,,20160401 11:05:01 EST,closed,20160401 11:05:01 EST,0.76945,,,1.0,1.0,,AUDUSD,,-0.4,1.0,19378.6,4.0,400102.0,19818.6
111.0,-4.4,20160401 15:15:19 EST,20160401 15:15:19 EST,20160401 15:15:19 EST,0.76945,,AUDUSD,long,,20160401 14:44:00 EST,closed,20160401 14:44:00 EST,0.76949,,,1.0,1.0,,AUDUSD,,-0.4,-1.0,19374.2,4.0,400101.6,19818.2
112.0,-4.4,20160401 15:32:58 EST,20160401 15:32:58 EST,20160401 15:32:58 EST,0.76949,,AUDUSD,short,,20160401 15:15:19 EST,closed,20160401 15:15:19 EST,0.76945,,,1.0,1.0,,AUDUSD,,-0.4,1.0,19369.8,4.0,400102.0,19817.8
113.0,-4.4,20160401 15:35:33 EST,20160401 15:35:33 EST,20160401 15:35:33 EST,0.76945,,AUDUSD,long,,20160401 15:32:58 EST,closed,20160401 15:32:58 EST,0.76949,,,1.0,1.0,,AUDUSD,,-0.4,-1.0,19365.4,4.0,400101.6,19817.4
114.0,-4.4,20160401 17:21:27 EST,20160401 17:21:27 EST,20160401 17:21:27 EST,0.76949,,AUDUSD,short,,20160401 15:35:33 EST,closed,20160401 15:35:33 EST,0.76945,,,1.0,1.0,,AUDUSD,,-0.4,1.0,19361.0,4.0,400102.0,19817.0
115.0,-4.4,20160401 17:45:08 EST,20160401 17:45:08 EST,20160401 17:45:08 EST,0.76945,,AUDUSD,long,,20160401 17:21:27 EST,closed,20160401 17:21:27 EST,0.76949,,,1.0,1.0,,AUDUSD,,-0.4,-1.0,19356.6,4.0,400101.6,19816.6
116.0,46.7,20160403 21:55:22 EST,20160403 21:55:22 EST,20160403 21:55:22 EST,0.76438,,AUDUSD,short,,20160401 17:45:08 EST,closed,20160401 17:45:08 EST,0.76945,,,1.0,1.0,,AUDUSD,,50.7,1.0,19403.3,4.0,400050.9,19867.3
117.0,-28.9,20160404 10:21:04 EST,20160404 10:21:04 EST,20160404 10:21:04 EST,0.76189,,AUDUSD,long,,20160403 21:55:22 EST,closed,20160403 21:55:22 EST,0.76438,,,1.0,1.0,,AUDUSD,,-24.9,-1.0,19374.4,4.0,400026.0,19842.4
118.0,7.4,20160404 19:35:13 EST,20160404 19:35:13 EST,20160404 19:35:13 EST,0.76075,,AUDUSD,short,,20160404 10:21:04 EST,closed,20160404 10:21:04 EST,0.76189,,,1.0,1.0,,AUDUSD,,11.4,1.0,19381.8,4.0,400014.6,19853.8
119.0,-17.4,20160404 20:05:15 EST,20160404 20:05:15 EST,20160404 20:05:15 EST,0.75941,,AUDUSD,long,,20160404 19:35:13 EST,closed,20160404 19:35:13 EST,0.76075,,,1.0,1.0,,AUDUSD,,-13.4,-1.0,19364.4,4.0,400001.2,19840.4
120.0,48.4,20160405 17:44:05 EST,20160405 17:44:05 EST,20160405 17:44:05 EST,0.75417,,AUDUSD,short,,20160404 20:05:15 EST,closed,20160404 20:05:15 EST,0.75941,,,1.0,1.0,,AUDUSD,,52.4,1.0,19412.8,4.0,399948.8,19892.8
121.0,-3.1,20160405 19:05:41 EST,20160405 19:05:41 EST,20160405 19:05:41 EST,0.75426,,AUDUSD,long,,20160405 17:44:05 EST,closed,20160405 17:44:05 EST,0.75417,,,1.0,1.0,,AUDUSD,,0.9,-1.0,19409.7,4.0,399949.7,19893.7
122.0,-15.7,20160405 20:36:28 EST,20160405 20:36:28 EST,20160405 20:36:28 EST,0.75543,,AUDUSD,short,,20160405 19:05:41 EST,closed,20160405 19:05:41 EST,0.75426,,,1.0,1.0,,AUDUSD,,-11.7,1.0,19394.0,4.0,399961.4,19882.0
123.0,-14.4,20160405 21:36:13 EST,20160405 21:36:13 EST,20160405 21:36:13 EST,0.75439,,AUDUSD,long,,20160405 20:36:28 EST,closed,20160405 20:36:28 EST,0.75543,,,1.0,1.0,,AUDUSD,,-10.4,-1.0,19379.6,4.0,399951.0,19871.6
124.0,-22.1,20160405 22:36:06 EST,20160405 22:36:06 EST,20160405 22:36:06 EST,0.7562,,AUDUSD,short,,20160405 21:36:13 EST,closed,20160405 21:36:13 EST,0.75439,,,1.0,1.0,,AUDUSD,,-18.1,1.0,19357.5,4.0,399969.1,19853.5
125.0,-17.3,20160406 05:37:57 EST,20160406 05:37:57 EST,20160406 05:37:57 EST,0.75487,,AUDUSD,long,,20160405 22:36:06 EST,closed,20160405 22:36:06 EST,0.7562,,,1.0,1.0,,AUDUSD,,-13.3,-1.0,19340.2,4.0,399955.8,19840.2
126.0,-28.3,20160406 10:04:34 EST,20160406 10:04:34 EST,20160406 10:04:34 EST,0.7573,,AUDUSD,short,,20160406 05:37:57 EST,closed,20160406 05:37:57 EST,0.75487,,,1.0,1.0,,AUDUSD,,-24.3,1.0,19311.9,4.0,399980.1,19815.9
127.0,-18.8,20160406 10:35:33 EST,20160406 10:35:33 EST,20160406 10:35:33 EST,0.75582,,AUDUSD,long,,20160406 10:04:34 EST,closed,20160406 10:04:34 EST,0.7573,,,1.0,1.0,,AUDUSD,,-14.8,-1.0,19293.1,4.0,399965.3,19801.1
128.0,-14.6,20160406 11:05:29 EST,20160406 11:05:29 EST,20160406 11:05:29 EST,0.75688,,AUDUSD,short,,20160406 10:35:33 EST,closed,20160406 10:35:33 EST,0.75582,,,1.0,1.0,,AUDUSD,,-10.6,1.0,19278.5,4.0,399975.9,19790.5
129.0,9.0,20160406 11:35:31 EST,20160406 11:35:31 EST,20160406 11:35:31 EST,0.75818,,AUDUSD,long,,20160406 11:05:29 EST,closed,20160406 11:05:29 EST,0.75688,,,1.0,1.0,,AUDUSD,,13.0,-1.0,19287.5,4.0,399988.9,19803.5
130.0,-28.0,20160406 12:35:16 EST,20160406 12:35:16 EST,20160406 12:35:16 EST,0.76058,,AUDUSD,short,,20160406 11:35:31 EST,closed,20160406 11:35:31 EST,0.75818,,,1.0,1.0,,AUDUSD,,-24.0,1.0,19259.5,4.0,400012.9,19779.5
131.0,-14.1,20160406 13:34:02 EST,20160406 13:34:02 EST,20160406 13:34:02 EST,0.75957,,AUDUSD,long,,20160406 12:35:16 EST,closed,20160406 12:35:16 EST,0.76058,,,1.0,1.0,,AUDUSD,,-10.1,-1.0,19245.4,4.0,400002.8,19769.4
132.0,3.5,20160406 14:05:31 EST,20160406 14:05:31 EST,20160406 14:05:31 EST,0.75882,,AUDUSD,short,,20160406 13:34:02 EST,closed,20160406 13:34:02 EST,0.75957,,,1.0,1.0,,AUDUSD,,7.5,1.0,19248.9,4.0,399995.3,19776.9
133.0,6.2,20160406 17:34:49 EST,20160406 17:34:49 EST,20160406 17:34:49 EST,0.75984,,AUDUSD,long,,20160406 14:05:31 EST,closed,20160406 14:05:31 EST,0.75882,,,1.0,1.0,,AUDUSD,,10.2,-1.0,19255.1,4.0,400005.5,19787.1
134.0,-2.0,,,,0.0,,AUDUSD,short,,20160406 17:34:49 EST,open,20160406 17:34:49 EST,0.75984,,,0.0,1.0,,AUDUSD,,0.0,-1.0,19253.1,2.0,392407.1,19787.1
