trade_id,PL,closeVWAP_timestamp,closedWhen,closedWhenUnixTimeStamp,closing_price_VWAP,expir,instrument,long_or_short,markToMarket_time,openVWAP_timestamp,open_or_closed,openedWhen,opening_price_VWAP,ptValue,putcall,quant_closed,quant_opened,strike,symbol,symbol_description,PurePL,qty,balance,commission,margin_available,purebalance,mark_to_mkt,pure_mark_to_mkt,pure_unr_pnl,unr_pnl,currency
1.0,-4.5,20160323 05:48:06 EST,20160323 05:48:06 EST,20160323 05:48:06 EST,0.67041,,NZDUSD,long,,20160323 05:41:09 EST,closed,20160323 05:41:09 EST,0.67046,,,1.0,1.0,,NZDUSD,,-0.500000000001,-1.0,19995.5,4.0,399999.5,19999.5,,,,,
2.0,1.1,20160323 06:24:52 EST,20160323 06:24:52 EST,20160323 06:24:52 EST,0.6699,,NZDUSD,short,,20160323 05:48:06 EST,closed,20160323 05:48:06 EST,0.67041,,,1.0,1.0,,NZDUSD,,5.1,1.0,19996.6,4.0,399994.4,20004.6,,,,,
3.0,0.2,20160323 06:46:36 EST,20160323 06:46:36 EST,20160323 06:46:36 EST,0.67032,,NZDUSD,long,,20160323 06:24:52 EST,closed,20160323 06:24:52 EST,0.6699,,,1.0,1.0,,NZDUSD,,4.2,-1.0,19996.8,4.0,399998.6,20008.8,,,,,
4.0,-13.0,20160323 07:14:01 EST,20160323 07:14:01 EST,20160323 07:14:01 EST,0.67122,,NZDUSD,short,,20160323 06:46:36 EST,closed,20160323 06:46:36 EST,0.67032,,,1.0,1.0,,NZDUSD,,-9.0,1.0,19983.8,4.0,400007.6,19999.8,,,,,
5.0,-1.4,20160323 08:04:07 EST,20160323 08:04:07 EST,20160323 08:04:07 EST,0.67148,,NZDUSD,long,,20160323 07:14:01 EST,closed,20160323 07:14:01 EST,0.67122,,,1.0,1.0,,NZDUSD,,2.6,-1.0,19982.4,4.0,400010.2,20002.4,,,,,
6.0,11.8,20160323 09:02:07 EST,20160323 09:02:07 EST,20160323 09:02:07 EST,0.6699,,NZDUSD,short,,20160323 08:04:07 EST,closed,20160323 08:04:07 EST,0.67148,,,1.0,1.0,,NZDUSD,,15.8,1.0,19994.2,4.0,399994.4,20018.2,,,,,
7.0,4.8,20160323 11:00:19 EST,20160323 11:00:19 EST,20160323 11:00:19 EST,0.67078,,NZDUSD,long,,20160323 09:02:07 EST,closed,20160323 09:02:07 EST,0.6699,,,1.0,1.0,,NZDUSD,,8.8,-1.0,19999.0,4.0,400003.2,20027.0,,,,,
8.0,7.2,20160323 11:48:37 EST,20160323 11:48:37 EST,20160323 11:48:37 EST,0.66966,,NZDUSD,short,,20160323 11:00:19 EST,closed,20160323 11:00:19 EST,0.67078,,,1.0,1.0,,NZDUSD,,11.2,1.0,20006.2,4.0,399992.0,20038.2,,,,,
9.0,-6.7,20160323 12:15:55 EST,20160323 12:15:55 EST,20160323 12:15:55 EST,0.66939,,NZDUSD,long,,20160323 11:48:37 EST,closed,20160323 11:48:37 EST,0.66966,,,1.0,1.0,,NZDUSD,,-2.7,-1.0,19999.5,4.0,399989.3,20035.5,,,,,
10.0,-2.7,20160323 12:41:40 EST,20160323 12:41:40 EST,20160323 12:41:40 EST,0.66926,,NZDUSD,short,,20160323 12:15:55 EST,closed,20160323 12:15:55 EST,0.66939,,,1.0,1.0,,NZDUSD,,1.3,1.0,19996.8,4.0,399988.0,20036.8,,,,,
11.0,6.5,20160323 13:06:15 EST,20160323 13:06:15 EST,20160323 13:06:15 EST,0.67031,,NZDUSD,long,,20160323 12:41:40 EST,closed,20160323 12:41:40 EST,0.66926,,,1.0,1.0,,NZDUSD,,10.5,-1.0,20003.3,4.0,399998.5,20047.3,,,,,
12.0,-11.4,20160323 13:32:34 EST,20160323 13:32:34 EST,20160323 13:32:34 EST,0.67105,,NZDUSD,short,,20160323 13:06:15 EST,closed,20160323 13:06:15 EST,0.67031,,,1.0,1.0,,NZDUSD,,-7.4,1.0,19991.9,4.0,400005.9,20039.9,,,,,
13.0,-3.1,20160323 14:31:22 EST,20160323 14:31:22 EST,20160323 14:31:22 EST,0.67114,,NZDUSD,long,,20160323 13:32:34 EST,closed,20160323 13:32:34 EST,0.67105,,,1.0,1.0,,NZDUSD,,0.899999999999,-1.0,19988.8,4.0,400006.8,20040.8,,,,,
14.0,-0.1,20160323 15:29:28 EST,20160323 15:29:28 EST,20160323 15:29:28 EST,0.67075,,NZDUSD,short,,20160323 14:31:22 EST,closed,20160323 14:31:22 EST,0.67114,,,1.0,1.0,,NZDUSD,,3.9,1.0,19988.7,4.0,400002.9,20044.7,,,,,
15.0,-9.1,20160323 15:52:44 EST,20160323 15:52:44 EST,20160323 15:52:44 EST,0.67024,,NZDUSD,long,,20160323 15:29:28 EST,closed,20160323 15:29:28 EST,0.67075,,,1.0,1.0,,NZDUSD,,-5.1,-1.0,19979.6,4.0,399997.8,20039.6,,,,,
16.0,-6.1,20160323 17:37:56 EST,20160323 17:37:56 EST,20160323 17:37:56 EST,0.67045,,NZDUSD,short,,20160323 15:52:44 EST,closed,20160323 15:52:44 EST,0.67024,,,1.0,1.0,,NZDUSD,,-2.1,1.0,19973.5,4.0,399999.9,20037.5,,,,,
17.0,-0.699999999999,20160323 18:03:33 EST,20160323 18:03:33 EST,20160323 18:03:33 EST,0.67078,,NZDUSD,long,,20160323 17:37:56 EST,closed,20160323 17:37:56 EST,0.67045,,,1.0,1.0,,NZDUSD,,3.3,-1.0,19972.8,4.0,400003.2,20040.8,,,,,
18.0,-12.5,20160323 18:28:39 EST,20160323 18:28:39 EST,20160323 18:28:39 EST,0.67163,,NZDUSD,short,,20160323 18:03:33 EST,closed,20160323 18:03:33 EST,0.67078,,,1.0,1.0,,NZDUSD,,-8.5,1.0,19960.3,4.0,400011.7,20032.3,,,,,
19.0,-6.0,20160323 19:28:32 EST,20160323 19:28:32 EST,20160323 19:28:32 EST,0.67143,,NZDUSD,long,,20160323 18:28:39 EST,closed,20160323 18:28:39 EST,0.67163,,,1.0,1.0,,NZDUSD,,-2.0,-1.0,19954.3,4.0,400009.7,20030.3,,,,,
20.0,-10.4,20160323 19:57:08 EST,20160323 19:57:08 EST,20160323 19:57:08 EST,0.67207,,NZDUSD,short,,20160323 19:28:32 EST,closed,20160323 19:28:32 EST,0.67143,,,1.0,1.0,,NZDUSD,,-6.4,1.0,19943.9,4.0,400016.1,20023.9,,,,,
21.0,-14.8,20160323 20:29:52 EST,20160323 20:29:52 EST,20160323 20:29:52 EST,0.67099,,NZDUSD,long,,20160323 19:57:08 EST,closed,20160323 19:57:08 EST,0.67207,,,1.0,1.0,,NZDUSD,,-10.8,-1.0,19929.1,4.0,400005.3,20013.1,,,,,
22.0,5.9,20160323 21:29:44 EST,20160323 21:29:44 EST,20160323 21:29:44 EST,0.67,,NZDUSD,short,,20160323 20:29:52 EST,closed,20160323 20:29:52 EST,0.67099,,,1.0,1.0,,NZDUSD,,9.9,1.0,19935.0,4.0,399995.4,20023.0,,,,,
23.0,-6.6,20160323 23:12:26 EST,20160323 23:12:26 EST,20160323 23:12:26 EST,0.66974,,NZDUSD,long,,20160323 21:29:44 EST,closed,20160323 21:29:44 EST,0.67,,,1.0,1.0,,NZDUSD,,-2.6,-1.0,19928.4,4.0,399992.8,20020.4,,,,,
24.0,-4.9,20160323 23:45:39 EST,20160323 23:45:39 EST,20160323 23:45:39 EST,0.66983,,NZDUSD,short,,20160323 23:12:26 EST,closed,20160323 23:12:26 EST,0.66974,,,1.0,1.0,,NZDUSD,,-0.9,1.0,19923.5,4.0,399993.7,20019.5,,,,,
25.0,-7.0,20160324 00:44:05 EST,20160324 00:44:05 EST,20160324 00:44:05 EST,0.66953,,NZDUSD,long,,20160323 23:45:39 EST,closed,20160323 23:45:39 EST,0.66983,,,1.0,1.0,,NZDUSD,,-3.0,-1.0,19916.5,4.0,399990.7,20016.5,,,,,
26.0,-4.1,20160324 01:11:14 EST,20160324 01:11:14 EST,20160324 01:11:14 EST,0.66954,,NZDUSD,short,,20160324 00:44:05 EST,closed,20160324 00:44:05 EST,0.66953,,,1.0,1.0,,NZDUSD,,-0.0999999999995,1.0,19912.4,4.0,399990.8,20016.4,,,,,
27.0,-6.1,20160324 01:36:49 EST,20160324 01:36:49 EST,20160324 01:36:49 EST,0.66933,,NZDUSD,long,,20160324 01:11:14 EST,closed,20160324 01:11:14 EST,0.66954,,,1.0,1.0,,NZDUSD,,-2.1,-1.0,19906.3,4.0,399988.7,20014.3,,,,,
28.0,-2.4,20160324 02:02:28 EST,20160324 02:02:28 EST,20160324 02:02:28 EST,0.66917,,NZDUSD,short,,20160324 01:36:49 EST,closed,20160324 01:36:49 EST,0.66933,,,1.0,1.0,,NZDUSD,,1.6,1.0,19903.9,4.0,399987.1,20015.9,,,,,
29.0,-3.4,20160324 02:43:13 EST,20160324 02:43:13 EST,20160324 02:43:13 EST,0.66923,,NZDUSD,long,,20160324 02:02:28 EST,closed,20160324 02:02:28 EST,0.66917,,,1.0,1.0,,NZDUSD,,0.600000000001,-1.0,19900.5,4.0,399987.7,20016.5,,,,,
30.0,11.1,20160324 04:00:42 EST,20160324 04:00:42 EST,20160324 04:00:42 EST,0.66772,,NZDUSD,short,,20160324 02:43:13 EST,closed,20160324 02:43:13 EST,0.66923,,,1.0,1.0,,NZDUSD,,15.1,1.0,19911.6,4.0,399972.6,20031.6,,,,,
31.0,7.5,20160324 04:27:40 EST,20160324 04:27:40 EST,20160324 04:27:40 EST,0.66887,,NZDUSD,long,,20160324 04:00:42 EST,closed,20160324 04:00:42 EST,0.66772,,,1.0,1.0,,NZDUSD,,11.5,-1.0,19919.1,4.0,399984.1,20043.1,,,,,
32.0,0.2,20160324 04:53:10 EST,20160324 04:53:10 EST,20160324 04:53:10 EST,0.66845,,NZDUSD,short,,20160324 04:27:40 EST,closed,20160324 04:27:40 EST,0.66887,,,1.0,1.0,,NZDUSD,,4.2,1.0,19919.3,4.0,399979.9,20047.3,,,,,
33.0,-10.7,20160324 05:20:39 EST,20160324 05:20:39 EST,20160324 05:20:39 EST,0.66778,,NZDUSD,long,,20160324 04:53:10 EST,closed,20160324 04:53:10 EST,0.66845,,,1.0,1.0,,NZDUSD,,-6.7,-1.0,19908.6,4.0,399973.2,20040.6,,,,,
34.0,-11.4,20160324 06:13:09 EST,20160324 06:13:09 EST,20160324 06:13:09 EST,0.66852,,NZDUSD,short,,20160324 05:20:39 EST,closed,20160324 05:20:39 EST,0.66778,,,1.0,1.0,,NZDUSD,,-7.4,1.0,19897.2,4.0,399980.6,20033.2,,,,,
35.0,7.2,20160324 06:42:45 EST,20160324 06:42:45 EST,20160324 06:42:45 EST,0.66964,,NZDUSD,long,,20160324 06:13:09 EST,closed,20160324 06:13:09 EST,0.66852,,,1.0,1.0,,NZDUSD,,11.2,-1.0,19904.4,4.0,399991.8,20044.4,,,,,
36.0,3.1,20160324 07:37:50 EST,20160324 07:37:50 EST,20160324 07:37:50 EST,0.66893,,NZDUSD,short,,20160324 06:42:45 EST,closed,20160324 06:42:45 EST,0.66964,,,1.0,1.0,,NZDUSD,,7.1,1.0,19907.5,4.0,399984.7,20051.5,,,,,
37.0,-5.3,20160324 08:02:07 EST,20160324 08:02:07 EST,20160324 08:02:07 EST,0.6688,,NZDUSD,long,,20160324 07:37:50 EST,closed,20160324 07:37:50 EST,0.66893,,,1.0,1.0,,NZDUSD,,-1.3,-1.0,19902.2,4.0,399983.4,20050.2,,,,,
38.0,-20.9,20160324 08:56:16 EST,20160324 08:56:16 EST,20160324 08:56:16 EST,0.67049,,NZDUSD,short,,20160324 08:02:07 EST,closed,20160324 08:02:07 EST,0.6688,,,1.0,1.0,,NZDUSD,,-16.9,1.0,19881.3,4.0,400000.3,20033.3,,,,,
39.0,-5.5,20160324 09:51:03 EST,20160324 09:51:03 EST,20160324 09:51:03 EST,0.67034,,NZDUSD,long,,20160324 08:56:16 EST,closed,20160324 08:56:16 EST,0.67049,,,1.0,1.0,,NZDUSD,,-1.5,-1.0,19875.8,4.0,399998.8,20031.8,,,,,
40.0,2.8,20160324 11:30:34 EST,20160324 11:30:34 EST,20160324 11:30:34 EST,0.66966,,NZDUSD,short,,20160324 09:51:03 EST,closed,20160324 09:51:03 EST,0.67034,,,1.0,1.0,,NZDUSD,,6.8,1.0,19878.6,4.0,399992.0,20038.6,,,,,
41.0,-7.4,20160324 11:55:51 EST,20160324 11:55:51 EST,20160324 11:55:51 EST,0.66932,,NZDUSD,long,,20160324 11:30:34 EST,closed,20160324 11:30:34 EST,0.66966,,,1.0,1.0,,NZDUSD,,-3.4,-1.0,19871.2,4.0,399988.6,20035.2,,,,,
42.0,-8.1,20160324 12:23:36 EST,20160324 12:23:36 EST,20160324 12:23:36 EST,0.66973,,NZDUSD,short,,20160324 11:55:51 EST,closed,20160324 11:55:51 EST,0.66932,,,1.0,1.0,,NZDUSD,,-4.1,1.0,19863.1,4.0,399992.7,20031.1,,,,,
43.0,-5.2,20160324 12:48:44 EST,20160324 12:48:44 EST,20160324 12:48:44 EST,0.66961,,NZDUSD,long,,20160324 12:23:36 EST,closed,20160324 12:23:36 EST,0.66973,,,1.0,1.0,,NZDUSD,,-1.2,-1.0,19857.9,4.0,399991.5,20029.9,,,,,
44.0,-10.7,20160324 14:32:33 EST,20160324 14:32:33 EST,20160324 14:32:33 EST,0.67028,,NZDUSD,short,,20160324 12:48:44 EST,closed,20160324 12:48:44 EST,0.66961,,,1.0,1.0,,NZDUSD,,-6.7,1.0,19847.2,4.0,399998.2,20023.2,,,,,
45.0,-4.8,20160324 14:57:50 EST,20160324 14:57:50 EST,20160324 14:57:50 EST,0.6702,,NZDUSD,long,,20160324 14:32:33 EST,closed,20160324 14:32:33 EST,0.67028,,,1.0,1.0,,NZDUSD,,-0.8,-1.0,19842.4,4.0,399997.4,20022.4,,,,,
46.0,-5.6,20160324 15:53:00 EST,20160324 15:53:00 EST,20160324 15:53:00 EST,0.67036,,NZDUSD,short,,20160324 14:57:50 EST,closed,20160324 14:57:50 EST,0.6702,,,1.0,1.0,,NZDUSD,,-1.6,1.0,19836.8,4.0,399999.0,20020.8,,,,,
47.0,-6.8,20160324 16:51:20 EST,20160324 16:51:20 EST,20160324 16:51:20 EST,0.67008,,NZDUSD,long,,20160324 15:53:00 EST,closed,20160324 15:53:00 EST,0.67036,,,1.0,1.0,,NZDUSD,,-2.8,-1.0,19830.0,4.0,399996.2,20018.0,,,,,
48.0,2.5,20160324 18:57:11 EST,20160324 18:57:11 EST,20160324 18:57:11 EST,0.66943,,NZDUSD,short,,20160324 16:51:20 EST,closed,20160324 16:51:20 EST,0.67008,,,1.0,1.0,,NZDUSD,,6.5,1.0,19832.5,4.0,399989.7,20024.5,,,,,
49.0,3.7,20160324 19:22:22 EST,20160324 19:22:22 EST,20160324 19:22:22 EST,0.6702,,NZDUSD,long,,20160324 18:57:11 EST,closed,20160324 18:57:11 EST,0.66943,,,1.0,1.0,,NZDUSD,,7.7,-1.0,19836.2,4.0,399997.4,20032.2,,,,,
50.0,9.0,20160324 21:17:54 EST,20160324 21:17:54 EST,20160324 21:17:54 EST,0.6689,,NZDUSD,short,,20160324 19:22:22 EST,closed,20160324 19:22:22 EST,0.6702,,,1.0,1.0,,NZDUSD,,13.0,1.0,19845.2,4.0,399984.4,20045.2,,,,,
51.0,-9.5,20160324 21:54:11 EST,20160324 21:54:11 EST,20160324 21:54:11 EST,0.66835,,NZDUSD,long,,20160324 21:17:54 EST,closed,20160324 21:17:54 EST,0.6689,,,1.0,1.0,,NZDUSD,,-5.5,-1.0,19835.7,4.0,399978.9,20039.7,,,,,
52.0,-13.5,20160324 23:20:19 EST,20160324 23:20:19 EST,20160324 23:20:19 EST,0.6693,,NZDUSD,short,,20160324 21:54:11 EST,closed,20160324 21:54:11 EST,0.66835,,,1.0,1.0,,NZDUSD,,-9.5,1.0,19822.2,4.0,399988.4,20030.2,,,,,
53.0,-5.6,20160325 01:34:12 EST,20160325 01:34:12 EST,20160325 01:34:12 EST,0.66914,,NZDUSD,long,,20160324 23:20:19 EST,closed,20160324 23:20:19 EST,0.6693,,,1.0,1.0,,NZDUSD,,-1.6,-1.0,19816.6,4.0,399986.8,20028.6,,,,,
54.0,-8.4,20160325 02:21:01 EST,20160325 02:21:01 EST,20160325 02:21:01 EST,0.66958,,NZDUSD,short,,20160325 01:34:12 EST,closed,20160325 01:34:12 EST,0.66914,,,1.0,1.0,,NZDUSD,,-4.4,1.0,19808.2,4.0,399991.2,20024.2,,,,,
55.0,-3.4,20160325 04:09:21 EST,20160325 04:09:21 EST,20160325 04:09:21 EST,0.66964,,NZDUSD,long,,20160325 02:21:01 EST,closed,20160325 02:21:01 EST,0.66958,,,1.0,1.0,,NZDUSD,,0.599999999999,-1.0,19804.8,4.0,399991.8,20024.8,,,,,
56.0,-9.6,20160325 04:56:39 EST,20160325 04:56:39 EST,20160325 04:56:39 EST,0.6702,,NZDUSD,short,,20160325 04:09:21 EST,closed,20160325 04:09:21 EST,0.66964,,,1.0,1.0,,NZDUSD,,-5.6,1.0,19795.2,4.0,399997.4,20019.2,,,,,
57.0,-9.0,20160325 05:04:47 EST,20160325 05:04:47 EST,20160325 05:04:47 EST,0.6697,,NZDUSD,long,,20160325 04:56:39 EST,closed,20160325 04:56:39 EST,0.6702,,,1.0,1.0,,NZDUSD,,-5.0,-1.0,19786.2,4.0,399992.4,20014.2,,,,,
58.0,-14.1,20160325 07:24:57 EST,20160325 07:24:57 EST,20160325 07:24:57 EST,0.67071,,NZDUSD,short,,20160325 05:04:47 EST,closed,20160325 05:04:47 EST,0.6697,,,1.0,1.0,,NZDUSD,,-10.1,1.0,19772.1,4.0,400002.5,20004.1,,,,,
59.0,-12.7,20160325 07:52:07 EST,20160325 07:52:07 EST,20160325 07:52:07 EST,0.66984,,NZDUSD,long,,20160325 07:24:57 EST,closed,20160325 07:24:57 EST,0.67071,,,1.0,1.0,,NZDUSD,,-8.7,-1.0,19759.4,4.0,399993.8,19995.4,,,,,
60.0,-8.1,20160325 08:17:17 EST,20160325 08:17:17 EST,20160325 08:17:17 EST,0.67025,,NZDUSD,short,,20160325 07:52:07 EST,closed,20160325 07:52:07 EST,0.66984,,,1.0,1.0,,NZDUSD,,-4.1,1.0,19751.3,4.0,399997.9,19991.3,,,,,
61.0,-10.0,20160325 08:31:23 EST,20160325 08:31:23 EST,20160325 08:31:23 EST,0.66965,,NZDUSD,long,,20160325 08:17:17 EST,closed,20160325 08:17:17 EST,0.67025,,,1.0,1.0,,NZDUSD,,-6.0,-1.0,19741.3,4.0,399991.9,19985.3,,,,,
62.0,-6.2,20160325 09:47:21 EST,20160325 09:47:21 EST,20160325 09:47:21 EST,0.66987,,NZDUSD,short,,20160325 08:31:23 EST,closed,20160325 08:31:23 EST,0.66965,,,1.0,1.0,,NZDUSD,,-2.2,1.0,19735.1,4.0,399994.1,19983.1,,,,,
63.0,-9.5,20160325 10:00:26 EST,20160325 10:00:26 EST,20160325 10:00:26 EST,0.66932,,NZDUSD,long,,20160325 09:47:21 EST,closed,20160325 09:47:21 EST,0.66987,,,1.0,1.0,,NZDUSD,,-5.5,-1.0,19725.6,4.0,399988.6,19977.6,,,,,
64.0,-8.0,20160325 10:45:53 EST,20160325 10:45:53 EST,20160325 10:45:53 EST,0.66972,,NZDUSD,short,,20160325 10:00:26 EST,closed,20160325 10:00:26 EST,0.66932,,,1.0,1.0,,NZDUSD,,-4.0,1.0,19717.6,4.0,399992.6,19973.6,,,,,
65.0,-19.7,20160325 11:30:38 EST,20160325 11:30:38 EST,20160325 11:30:38 EST,0.66815,,NZDUSD,long,,20160325 10:45:53 EST,closed,20160325 10:45:53 EST,0.66972,,,1.0,1.0,,NZDUSD,,-15.7,-1.0,19697.9,4.0,399976.9,19957.9,,,,,
66.0,-9.9,20160325 16:32:26 EST,20160325 16:32:26 EST,20160325 16:32:26 EST,0.66874,,NZDUSD,short,,20160325 11:30:38 EST,closed,20160325 11:30:38 EST,0.66815,,,1.0,1.0,,NZDUSD,,-5.9,1.0,19688.0,4.0,399982.8,19952.0,,,,,
67.0,-8.5,20160325 16:46:33 EST,20160325 16:46:33 EST,20160325 16:46:33 EST,0.66829,,NZDUSD,long,,20160325 16:32:26 EST,closed,20160325 16:32:26 EST,0.66874,,,1.0,1.0,,NZDUSD,,-4.5,-1.0,19679.5,4.0,399978.3,19947.5,,,,,
68.0,-53.8,20160328 09:41:55 EST,20160328 09:41:55 EST,20160328 09:41:55 EST,0.67327,,NZDUSD,short,,20160325 16:46:33 EST,closed,20160325 16:46:33 EST,0.66829,,,1.0,1.0,,NZDUSD,,-49.8,1.0,19625.7,4.0,400028.1,19897.7,,,,,
69.0,-10.0,20160328 10:10:02 EST,20160328 10:10:02 EST,20160328 10:10:02 EST,0.67267,,NZDUSD,long,,20160328 09:41:55 EST,closed,20160328 09:41:55 EST,0.67327,,,1.0,1.0,,NZDUSD,,-6.0,-1.0,19615.7,4.0,400022.1,19891.7,,,,,
70.0,-4.8,20160328 10:36:17 EST,20160328 10:36:17 EST,20160328 10:36:17 EST,0.67275,,NZDUSD,short,,20160328 10:10:02 EST,closed,20160328 10:10:02 EST,0.67267,,,1.0,1.0,,NZDUSD,,-0.8,1.0,19610.9,4.0,400022.9,19890.9,,,,,
71.0,-2.1,20160328 15:48:57 EST,20160328 15:48:57 EST,20160328 15:48:57 EST,0.67294,,NZDUSD,long,,20160328 10:36:17 EST,closed,20160328 10:36:17 EST,0.67275,,,1.0,1.0,,NZDUSD,,1.9,-1.0,19608.8,4.0,400024.8,19892.8,,,,,
72.0,0.8,20160328 18:39:32 EST,20160328 18:39:32 EST,20160328 18:39:32 EST,0.67246,,NZDUSD,short,,20160328 15:48:57 EST,closed,20160328 15:48:57 EST,0.67294,,,1.0,1.0,,NZDUSD,,4.8,1.0,19609.6,4.0,400020.0,19897.6,,,,,
73.0,8.6,20160328 20:13:57 EST,20160328 20:13:57 EST,20160328 20:13:57 EST,0.67372,,NZDUSD,long,,20160328 18:39:32 EST,closed,20160328 18:39:32 EST,0.67246,,,1.0,1.0,,NZDUSD,,12.6,-1.0,19618.2,4.0,400032.6,19910.2,,,,,
74.0,-4.2,20160328 20:44:37 EST,20160328 20:44:37 EST,20160328 20:44:37 EST,0.67374,,NZDUSD,short,,20160328 20:13:57 EST,closed,20160328 20:13:57 EST,0.67372,,,1.0,1.0,,NZDUSD,,-0.2,1.0,19614.0,4.0,400032.8,19910.0,,,,,
75.0,103.6,20160329 12:32:20 EST,20160329 12:32:20 EST,20160329 12:32:20 EST,0.6845,,NZDUSD,long,,20160328 20:44:37 EST,closed,20160328 20:44:37 EST,0.67374,,,1.0,1.0,,NZDUSD,,107.6,-1.0,19717.6,4.0,400140.4,20017.6,,,,,
76.0,-8.3,20160329 13:09:54 EST,20160329 13:09:54 EST,20160329 13:09:54 EST,0.68493,,NZDUSD,short,,20160329 12:32:20 EST,closed,20160329 12:32:20 EST,0.6845,,,1.0,1.0,,NZDUSD,,-4.3,1.0,19709.3,4.0,400144.7,20013.3,,,,,
77.0,-1.8,20160329 19:34:35 EST,20160329 19:34:35 EST,20160329 19:34:35 EST,0.68515,,NZDUSD,long,,20160329 13:09:54 EST,closed,20160329 13:09:54 EST,0.68493,,,1.0,1.0,,NZDUSD,,2.2,-1.0,19707.5,4.0,400146.9,20015.5,,,,,
78.0,-18.2,20160329 20:03:32 EST,20160329 20:03:32 EST,20160329 20:03:32 EST,0.68657,,NZDUSD,short,,20160329 19:34:35 EST,closed,20160329 19:34:35 EST,0.68515,,,1.0,1.0,,NZDUSD,,-14.2,1.0,19689.3,4.0,400161.1,20001.3,,,,,
79.0,45.5,20160330 05:36:39 EST,20160330 05:36:39 EST,20160330 05:36:39 EST,0.69152,,NZDUSD,long,,20160329 20:03:32 EST,closed,20160329 20:03:32 EST,0.68657,,,1.0,1.0,,NZDUSD,,49.5,-1.0,19734.8,4.0,400210.6,20050.8,,,,,
80.0,-21.8,20160330 06:48:35 EST,20160330 06:48:35 EST,20160330 06:48:35 EST,0.6933,,NZDUSD,short,,20160330 05:36:39 EST,closed,20160330 05:36:39 EST,0.69152,,,1.0,1.0,,NZDUSD,,-17.8,1.0,19713.0,4.0,400228.4,20033.0,,,,,
81.0,-12.3,20160331 05:33:46 EST,20160331 05:33:46 EST,20160331 05:33:46 EST,0.69247,,NZDUSD,long,,20160330 06:48:35 EST,closed,20160330 06:48:35 EST,0.6933,,,1.0,1.0,,NZDUSD,,-8.3,-1.0,19700.7,4.0,400220.1,20024.7,,,,,
82.0,-17.3,20160331 08:40:04 EST,20160331 08:40:04 EST,20160331 08:40:04 EST,0.6938,,NZDUSD,short,,20160331 05:33:46 EST,closed,20160331 05:33:46 EST,0.69247,,,1.0,1.0,,NZDUSD,,-13.3,1.0,19683.4,4.0,400233.4,20011.4,,,,,
83.0,-4.3,20160331 17:21:25 EST,20160331 17:21:25 EST,20160331 17:21:25 EST,0.69377,,NZDUSD,long,,20160331 08:40:04 EST,closed,20160331 08:40:04 EST,0.6938,,,1.0,1.0,,NZDUSD,,-0.3,-1.0,19679.1,4.0,400233.1,20011.1,,,,,
84.0,-4.3,20160331 22:20:52 EST,20160331 22:20:52 EST,20160331 22:20:52 EST,0.6938,,NZDUSD,short,,20160331 17:21:25 EST,closed,20160331 17:21:25 EST,0.69377,,,1.0,1.0,,NZDUSD,,-0.3,1.0,19674.8,4.0,400233.4,20010.8,,,,,
85.0,-4.3,20160401 04:34:08 EST,20160401 04:34:08 EST,20160401 04:34:08 EST,0.69377,,NZDUSD,long,,20160331 22:20:52 EST,closed,20160331 22:20:52 EST,0.6938,,,1.0,1.0,,NZDUSD,,-0.3,-1.0,19670.5,4.0,400233.1,20010.5,,,,,
86.0,-4.3,20160401 10:44:35 EST,20160401 10:44:35 EST,20160401 10:44:35 EST,0.6938,,NZDUSD,short,,20160401 04:34:08 EST,closed,20160401 04:34:08 EST,0.69377,,,1.0,1.0,,NZDUSD,,-0.3,1.0,19666.2,4.0,400233.4,20010.2,,,,,
87.0,-4.3,20160401 11:04:49 EST,20160401 11:04:49 EST,20160401 11:04:49 EST,0.69377,,NZDUSD,long,,20160401 10:44:35 EST,closed,20160401 10:44:35 EST,0.6938,,,1.0,1.0,,NZDUSD,,-0.3,-1.0,19661.9,4.0,400233.1,20009.9,,,,,
88.0,-4.3,20160401 11:08:51 EST,20160401 11:08:51 EST,20160401 11:08:51 EST,0.6938,,NZDUSD,short,,20160401 11:04:49 EST,closed,20160401 11:04:49 EST,0.69377,,,1.0,1.0,,NZDUSD,,-0.3,1.0,19657.6,4.0,400233.4,20009.6,,,,,
89.0,-4.3,20160401 11:44:38 EST,20160401 11:44:38 EST,20160401 11:44:38 EST,0.69377,,NZDUSD,long,,20160401 11:08:51 EST,closed,20160401 11:08:51 EST,0.6938,,,1.0,1.0,,NZDUSD,,-0.3,-1.0,19653.3,4.0,400233.1,20009.3,,,,,
90.0,-4.3,20160401 12:32:30 EST,20160401 12:32:30 EST,20160401 12:32:30 EST,0.6938,,NZDUSD,short,,20160401 11:44:38 EST,closed,20160401 11:44:38 EST,0.69377,,,1.0,1.0,,NZDUSD,,-0.3,1.0,19649.0,4.0,400233.4,20009.0,,,,,
91.0,-4.3,20160401 12:34:31 EST,20160401 12:34:31 EST,20160401 12:34:31 EST,0.69377,,NZDUSD,long,,20160401 12:32:30 EST,closed,20160401 12:32:30 EST,0.6938,,,1.0,1.0,,NZDUSD,,-0.3,-1.0,19644.7,4.0,400233.1,20008.7,,,,,
92.0,-4.3,20160401 14:38:43 EST,20160401 14:38:43 EST,20160401 14:38:43 EST,0.6938,,NZDUSD,short,,20160401 12:34:31 EST,closed,20160401 12:34:31 EST,0.69377,,,1.0,1.0,,NZDUSD,,-0.3,1.0,19640.4,4.0,400233.4,20008.4,,,,,
93.0,-4.3,20160401 14:44:19 EST,20160401 14:44:19 EST,20160401 14:44:19 EST,0.69377,,NZDUSD,long,,20160401 14:38:43 EST,closed,20160401 14:38:43 EST,0.6938,,,1.0,1.0,,NZDUSD,,-0.3,-1.0,19636.1,4.0,400233.1,20008.1,,,,,
94.0,-4.3,20160401 17:21:03 EST,20160401 17:21:03 EST,20160401 17:21:03 EST,0.6938,,NZDUSD,short,,20160401 14:44:19 EST,closed,20160401 14:44:19 EST,0.69377,,,1.0,1.0,,NZDUSD,,-0.3,1.0,19631.8,4.0,400233.4,20007.8,,,,,
95.0,-48.1,20160403 21:56:26 EST,20160403 21:56:26 EST,20160403 21:56:26 EST,0.68939,,NZDUSD,long,,20160401 17:21:03 EST,closed,20160401 17:21:03 EST,0.6938,,,1.0,1.0,,NZDUSD,,-44.1,-1.0,19583.7,4.0,400189.3,19963.7,,,,,
96.0,25.5,20160404 05:35:17 EST,20160404 05:35:17 EST,20160404 05:35:17 EST,0.68644,,NZDUSD,short,,20160403 21:56:26 EST,closed,20160403 21:56:26 EST,0.68939,,,1.0,1.0,,NZDUSD,,29.5,1.0,19609.2,4.0,400159.8,19993.2,,,,,
97.0,-12.0,20160404 06:04:56 EST,20160404 06:04:56 EST,20160404 06:04:56 EST,0.68564,,NZDUSD,long,,20160404 05:35:17 EST,closed,20160404 05:35:17 EST,0.68644,,,1.0,1.0,,NZDUSD,,-8.0,-1.0,19597.2,4.0,400151.8,19985.2,,,,,
98.0,-0.700000000001,20160404 10:22:45 EST,20160404 10:22:45 EST,20160404 10:22:45 EST,0.68531,,NZDUSD,short,,20160404 06:04:56 EST,closed,20160404 06:04:56 EST,0.68564,,,1.0,1.0,,NZDUSD,,3.3,1.0,19596.5,4.0,400148.5,19988.5,,,,,
99.0,19.1,20160404 20:36:08 EST,20160404 20:36:08 EST,20160404 20:36:08 EST,0.68062,,NZDUSD,short,,20160404 17:59:27 EST,closed,20160404 17:59:27 EST,0.68293,,,1.0,1.0,,NZDUSD,,23.1,1.0,19615.6,4.0,400125.4,20011.6,,,,,
100.0,3.2,20160404 21:07:01 EST,20160404 21:07:01 EST,20160404 21:07:01 EST,0.68134,,NZDUSD,long,,20160404 20:36:08 EST,closed,20160404 20:36:08 EST,0.68062,,,1.0,1.0,,NZDUSD,,7.2,-1.0,19618.8,4.0,400132.6,20018.8,,,,,
101.0,5.4,20160405 18:16:42 EST,20160405 18:16:42 EST,20160405 18:16:42 EST,0.6804,,NZDUSD,short,,20160404 21:07:01 EST,closed,20160404 21:07:01 EST,0.68134,,,1.0,1.0,,NZDUSD,,9.4,1.0,19624.2,4.0,400123.2,20028.2,,,,,
102.0,-3.5,20160405 22:07:53 EST,20160405 22:07:53 EST,20160405 22:07:53 EST,0.68045,,NZDUSD,long,,20160405 18:16:42 EST,closed,20160405 18:16:42 EST,0.6804,,,1.0,1.0,,NZDUSD,,0.5,-1.0,19620.7,4.0,400123.7,20028.7,,,,,
103.0,-11.3,20160405 22:37:45 EST,20160405 22:37:45 EST,20160405 22:37:45 EST,0.68118,,NZDUSD,short,,20160405 22:07:53 EST,closed,20160405 22:07:53 EST,0.68045,,,1.0,1.0,,NZDUSD,,-7.3,1.0,19609.4,4.0,400131.0,20021.4,,,,,
104.0,-10.7,20160405 23:08:47 EST,20160405 23:08:47 EST,20160405 23:08:47 EST,0.68051,,NZDUSD,long,,20160405 22:37:45 EST,closed,20160405 22:37:45 EST,0.68118,,,1.0,1.0,,NZDUSD,,-6.7,-1.0,19598.7,4.0,400124.3,20014.7,,,,,
105.0,-9.8,20160406 00:09:09 EST,20160406 00:09:09 EST,20160406 00:09:09 EST,0.68109,,NZDUSD,short,,20160405 23:08:47 EST,closed,20160405 23:08:47 EST,0.68051,,,1.0,1.0,,NZDUSD,,-5.8,1.0,19588.9,4.0,400130.1,20008.9,,,,,
106.0,0.6,20160406 01:08:54 EST,20160406 01:08:54 EST,20160406 01:08:54 EST,0.68155,,NZDUSD,long,,20160406 00:09:09 EST,closed,20160406 00:09:09 EST,0.68109,,,1.0,1.0,,NZDUSD,,4.6,-1.0,19589.5,4.0,400134.7,20013.5,,,,,
107.0,-5.1,20160406 01:38:52 EST,20160406 01:38:52 EST,20160406 01:38:52 EST,0.68166,,NZDUSD,short,,20160406 01:08:54 EST,closed,20160406 01:08:54 EST,0.68155,,,1.0,1.0,,NZDUSD,,-1.1,1.0,19584.4,4.0,400135.8,20012.4,,,,,
108.0,-8.4,20160406 02:01:40 EST,20160406 02:01:40 EST,20160406 02:01:40 EST,0.68122,,NZDUSD,long,,20160406 01:38:52 EST,closed,20160406 01:38:52 EST,0.68166,,,1.0,1.0,,NZDUSD,,-4.4,-1.0,19576.0,4.0,400131.4,20008.0,,,,,
109.0,-5.6,20160406 02:09:18 EST,20160406 02:09:18 EST,20160406 02:09:18 EST,0.68138,,NZDUSD,short,,20160406 02:01:40 EST,closed,20160406 02:01:40 EST,0.68122,,,1.0,1.0,,NZDUSD,,-1.6,1.0,19570.4,4.0,400133.0,20006.4,,,,,
110.0,-15.0,20160406 03:08:45 EST,20160406 03:08:45 EST,20160406 03:08:45 EST,0.68028,,NZDUSD,long,,20160406 02:09:18 EST,closed,20160406 02:09:18 EST,0.68138,,,1.0,1.0,,NZDUSD,,-11.0,-1.0,19555.4,4.0,400122.0,19995.4,,,,,
111.0,12.2,20160406 04:37:57 EST,20160406 04:37:57 EST,20160406 04:37:57 EST,0.67866,,NZDUSD,short,,20160406 03:08:45 EST,closed,20160406 03:08:45 EST,0.68028,,,1.0,1.0,,NZDUSD,,16.2,1.0,19567.6,4.0,400105.8,20011.6,,,,,
112.0,-2.1,20160406 05:39:43 EST,20160406 05:39:43 EST,20160406 05:39:43 EST,0.67885,,NZDUSD,long,,20160406 04:37:57 EST,closed,20160406 04:37:57 EST,0.67866,,,1.0,1.0,,NZDUSD,,1.9,-1.0,19565.5,4.0,400107.7,20013.5,,,,,
113.0,-21.6,20160406 10:06:15 EST,20160406 10:06:15 EST,20160406 10:06:15 EST,0.68061,,NZDUSD,short,,20160406 05:39:43 EST,closed,20160406 05:39:43 EST,0.67885,,,1.0,1.0,,NZDUSD,,-17.6,1.0,19543.9,4.0,400125.3,19995.9,,,,,
114.0,-3.2,20160406 11:08:07 EST,20160406 11:08:07 EST,20160406 11:08:07 EST,0.68069,,NZDUSD,long,,20160406 10:06:15 EST,closed,20160406 10:06:15 EST,0.68061,,,1.0,1.0,,NZDUSD,,0.8,-1.0,19540.7,4.0,400126.1,19996.7,,,,,
115.0,-28.9,20160406 12:06:58 EST,20160406 12:06:58 EST,20160406 12:06:58 EST,0.68318,,NZDUSD,short,,20160406 11:08:07 EST,closed,20160406 11:08:07 EST,0.68069,,,1.0,1.0,,NZDUSD,,-24.9,1.0,19511.8,4.0,400151.0,19971.8,,,,,
116.0,-14.4,20160406 13:07:15 EST,20160406 13:07:15 EST,20160406 13:07:15 EST,0.68214,,NZDUSD,long,,20160406 12:06:58 EST,closed,20160406 12:06:58 EST,0.68318,,,1.0,1.0,,NZDUSD,,-10.4,-1.0,19497.4,4.0,400140.6,19961.4,,,,,
117.0,-10.6,20160406 16:07:44 EST,20160406 16:07:44 EST,20160406 16:07:44 EST,0.6828,,NZDUSD,short,,20160406 13:07:15 EST,closed,20160406 13:07:15 EST,0.68214,,,1.0,1.0,,NZDUSD,,-6.6,1.0,19486.8,4.0,400147.2,19954.8,,,,,
118.0,-11.3,20160406 16:37:33 EST,20160406 16:37:33 EST,20160406 16:37:33 EST,0.68207,,NZDUSD,long,,20160406 16:07:44 EST,closed,20160406 16:07:44 EST,0.6828,,,1.0,1.0,,NZDUSD,,-7.3,-1.0,19475.5,4.0,400139.9,19947.5,,,,,
119.0,-7.2,20160406 17:36:40 EST,20160406 17:36:40 EST,20160406 17:36:40 EST,0.68239,,NZDUSD,short,,20160406 16:37:33 EST,closed,20160406 16:37:33 EST,0.68207,,,1.0,1.0,,NZDUSD,,-3.2,1.0,19468.3,4.0,400143.1,19944.3,,,,,
120.0,-4.9,20160406 18:07:03 EST,20160406 18:07:03 EST,20160406 18:07:03 EST,0.6823,,NZDUSD,long,,20160406 17:36:40 EST,closed,20160406 17:36:40 EST,0.68239,,,1.0,1.0,,NZDUSD,,-0.899999999999,-1.0,19463.4,4.0,400142.2,19943.4,,,,,
121.0,-16.1,20160406 20:41:37 EST,20160406 20:41:37 EST,20160406 20:41:37 EST,0.68351,,NZDUSD,short,,20160406 18:07:03 EST,closed,20160406 18:07:03 EST,0.6823,,,1.0,1.0,,NZDUSD,,-12.1,1.0,19447.3,4.0,400154.3,19931.3,,,,,
122.0,-9.8,20160406 20:51:41 EST,20160406 20:51:41 EST,20160406 20:51:41 EST,0.68293,,NZDUSD,long,,20160406 20:41:37 EST,closed,20160406 20:41:37 EST,0.68351,,,1.0,1.0,,NZDUSD,,-5.8,-1.0,19437.5,4.0,400148.5,19925.5,,,,,
123.0,14.3,20160406 21:39:44 EST,20160406 21:39:44 EST,20160406 21:39:44 EST,0.6811,,NZDUSD,short,,20160406 20:51:41 EST,closed,20160406 20:51:41 EST,0.68293,,,1.0,1.0,,NZDUSD,,18.3,1.0,19451.8,4.0,400130.2,19943.8,,,,,
124.0,6.0,20160407 00:39:13 EST,20160407 00:39:13 EST,20160407 00:39:13 EST,0.6821,,NZDUSD,long,,20160406 21:39:44 EST,closed,20160406 21:39:44 EST,0.6811,,,1.0,1.0,,NZDUSD,,10.0,-1.0,19457.8,4.0,400140.2,19953.8,19457.8,19953.8,0.0,0.0,
125.0,-2.0,,,,0.0,,NZDUSD,short,,20160407 00:39:13 EST,open,20160407 00:39:13 EST,0.6821,,,0.0,1.0,,NZDUSD,,0.0,-1.0,19455.8,2.0,393319.2,19953.8,19447.0,19947.0,,,
126.0,-3.0,20160407 01:09:44 EST,20160407 01:09:44 EST,20160407 01:09:44 EST,0.68322,,NZDUSD,short,,20160407 01:05:04 EST,closed,20160407 01:05:04 EST,0.68332,,,1.0,1.0,,NZDUSD,,0.999999999999,1.0,19452.8,4.0,393318.2,19954.8,19452.8,19954.8,-19.0,-21.0,USD
127.0,9.7,20160407 01:38:14 EST,20160407 01:38:14 EST,20160407 01:38:14 EST,0.68459,,NZDUSD,long,,20160407 01:09:44 EST,closed,20160407 01:09:44 EST,0.68322,,,1.0,1.0,,NZDUSD,,13.7,-1.0,19462.5,4.0,393331.9,19968.5,19462.5,19968.5,-18.7,-20.7,USD
128.0,-0.300000000001,20160407 02:07:14 EST,20160407 02:07:14 EST,20160407 02:07:14 EST,0.68422,,NZDUSD,short,,20160407 01:38:14 EST,closed,20160407 01:38:14 EST,0.68459,,,1.0,1.0,,NZDUSD,,3.7,1.0,19462.2,4.0,393328.2,19972.2,19462.2,19972.2,-31.7,-33.7,USD
129.0,-24.2,20160407 03:38:08 EST,20160407 03:38:08 EST,20160407 03:38:08 EST,0.6822,,NZDUSD,long,,20160407 02:07:14 EST,closed,20160407 02:07:14 EST,0.68422,,,1.0,1.0,,NZDUSD,,-20.2,-1.0,19438.0,4.0,393308.0,19952.0,19438.0,19952.0,-28.7,-30.7,USD
130.0,-7.0,20160407 04:07:42 EST,20160407 04:07:42 EST,20160407 04:07:42 EST,0.6825,,NZDUSD,short,,20160407 03:38:08 EST,closed,20160407 03:38:08 EST,0.6822,,,1.0,1.0,,NZDUSD,,-3.0,1.0,19431.0,4.0,393311.0,19949.0,19431.0,19949.0,-7.8,-9.8,USD
131.0,-22.1,20160407 07:06:32 EST,20160407 07:06:32 EST,20160407 07:06:32 EST,0.68069,,NZDUSD,long,,20160407 04:07:42 EST,closed,20160407 04:07:42 EST,0.6825,,,1.0,1.0,,NZDUSD,,-18.1,-1.0,19408.9,4.0,393292.9,19930.9,19408.9,19930.9,-11.5,-13.5,USD
132.0,12.7,20160407 08:07:16 EST,20160407 08:07:16 EST,20160407 08:07:16 EST,0.67902,,NZDUSD,short,,20160407 07:06:32 EST,closed,20160407 07:06:32 EST,0.68069,,,1.0,1.0,,NZDUSD,,16.7,1.0,19421.6,4.0,393276.2,19947.6,19421.6,19947.6,7.3,5.3,USD
133.0,-20.2,20160407 10:36:54 EST,20160407 10:36:54 EST,20160407 10:36:54 EST,0.6774,,NZDUSD,long,,20160407 08:07:16 EST,closed,20160407 08:07:16 EST,0.67902,,,1.0,1.0,,NZDUSD,,-16.2,-1.0,19401.4,4.0,393260.0,19931.4,19401.4,19931.4,23.3,21.3,USD
134.0,-0.3,20160407 13:07:41 EST,20160407 13:07:41 EST,20160407 13:07:41 EST,0.67703,,NZDUSD,short,,20160407 10:36:54 EST,closed,20160407 10:36:54 EST,0.6774,,,1.0,1.0,,NZDUSD,,3.7,1.0,19401.1,4.0,393256.3,19935.1,19401.1,19935.1,40.2,38.2,USD
135.0,-2.9,20160407 13:38:15 EST,20160407 13:38:15 EST,20160407 13:38:15 EST,0.67714,,NZDUSD,long,,20160407 13:07:41 EST,closed,20160407 13:07:41 EST,0.67703,,,1.0,1.0,,NZDUSD,,1.1,-1.0,19398.2,4.0,393257.4,19936.2,19398.2,19936.2,43.2,41.2,USD
136.0,-17.5,20160407 22:08:32 EST,20160407 22:08:32 EST,20160407 22:08:32 EST,0.67849,,NZDUSD,short,,20160407 13:38:15 EST,closed,20160407 13:38:15 EST,0.67714,,,1.0,1.0,,NZDUSD,,-13.5,1.0,19380.7,4.0,393270.9,19922.7,19380.7,19922.7,42.8,40.8,USD
137.0,-1.4,20160407 22:38:28 EST,20160407 22:38:28 EST,20160407 22:38:28 EST,0.67875,,NZDUSD,long,,20160407 22:08:32 EST,closed,20160407 22:08:32 EST,0.67849,,,1.0,1.0,,NZDUSD,,2.6,-1.0,19379.3,4.0,393273.5,19925.3,19379.3,19925.3,28.6,26.6,USD
138.0,1.1,20160407 23:38:16 EST,20160407 23:38:16 EST,20160407 23:38:16 EST,0.67824,,NZDUSD,short,,20160407 22:38:28 EST,closed,20160407 22:38:28 EST,0.67875,,,1.0,1.0,,NZDUSD,,5.1,1.0,19380.4,4.0,393268.4,19930.4,19380.4,19930.4,26.7,24.7,USD
139.0,-5.3,20160408 01:34:56 EST,20160408 01:34:56 EST,20160408 01:34:56 EST,0.67811,,NZDUSD,long,,20160407 23:38:16 EST,closed,20160407 23:38:16 EST,0.67824,,,1.0,1.0,,NZDUSD,,-1.3,-1.0,19375.1,4.0,393267.1,19929.1,19375.1,19929.1,31.1,29.1,USD
140.0,-9.5,20160408 02:08:26 EST,20160408 02:08:26 EST,20160408 02:08:26 EST,0.67866,,NZDUSD,short,,20160408 01:34:56 EST,closed,20160408 01:34:56 EST,0.67811,,,1.0,1.0,,NZDUSD,,-5.5,1.0,19365.6,4.0,393272.6,19923.6,19365.6,19923.6,33.1,31.1,USD
141.0,-2.0,,,,0.0,,NZDUSD,long,,20160408 02:08:26 EST,open,20160408 02:08:26 EST,0.67866,,,0.0,1.0,,NZDUSD,,0.0,1.0,19363.6,2.0,386486.0,19923.6,19388.5,19950.5,,,USD
