trade_id,PL,closeVWAP_timestamp,closedWhen,closedWhenUnixTimeStamp,closing_price_VWAP,expir,instrument,long_or_short,markToMarket_time,openVWAP_timestamp,open_or_closed,openedWhen,opening_price_VWAP,ptValue,putcall,quant_closed,quant_opened,strike,symbol,symbol_description,PurePL,qty,balance,commission,margin_available,purebalance
1.0,-4.5,20160323 05:48:06 EST,20160323 05:48:06 EST,20160323 05:48:06 EST,0.67041,,NZDUSD,long,,20160323 05:41:09 EST,closed,20160323 05:41:09 EST,0.67046,,,1.0,1.0,,NZDUSD,,-0.500000000001,-1.0,19995.5,4.0,399999.5,19999.5
2.0,1.1,20160323 06:24:52 EST,20160323 06:24:52 EST,20160323 06:24:52 EST,0.6699,,NZDUSD,short,,20160323 05:48:06 EST,closed,20160323 05:48:06 EST,0.67041,,,1.0,1.0,,NZDUSD,,5.1,1.0,19996.6,4.0,399994.4,20004.6
3.0,0.2,20160323 06:46:36 EST,20160323 06:46:36 EST,20160323 06:46:36 EST,0.67032,,NZDUSD,long,,20160323 06:24:52 EST,closed,20160323 06:24:52 EST,0.6699,,,1.0,1.0,,NZDUSD,,4.2,-1.0,19996.8,4.0,399998.6,20008.8
4.0,-13.0,20160323 07:14:01 EST,20160323 07:14:01 EST,20160323 07:14:01 EST,0.67122,,NZDUSD,short,,20160323 06:46:36 EST,closed,20160323 06:46:36 EST,0.67032,,,1.0,1.0,,NZDUSD,,-9.0,1.0,19983.8,4.0,400007.6,19999.8
5.0,-1.4,20160323 08:04:07 EST,20160323 08:04:07 EST,20160323 08:04:07 EST,0.67148,,NZDUSD,long,,20160323 07:14:01 EST,closed,20160323 07:14:01 EST,0.67122,,,1.0,1.0,,NZDUSD,,2.6,-1.0,19982.4,4.0,400010.2,20002.4
6.0,11.8,20160323 09:02:07 EST,20160323 09:02:07 EST,20160323 09:02:07 EST,0.6699,,NZDUSD,short,,20160323 08:04:07 EST,closed,20160323 08:04:07 EST,0.67148,,,1.0,1.0,,NZDUSD,,15.8,1.0,19994.2,4.0,399994.4,20018.2
7.0,-2.0,,,,0.0,,NZDUSD,long,,20160323 09:02:07 EST,open,20160323 09:02:07 EST,0.6699,,,0.0,1.0,,NZDUSD,,0.0,1.0,19992.2,2.0,393295.4,20018.2
