permid,account,clientid,commission,commission_currency,exchange,execid,expiry,level_0,orderid,price,qty,openqty,realized_PnL,side,symbol,symbol_currency,times,yield_redemption_date,PurePL,balance,margin_available,openprice,purebalance,real_pnl
1,Paper,Paper,9321.75,USD,BITSTAMP,1.0,,,1.0,372.87,1.0,-1.0,-9321.75,SLD,BTC,USD,20160322 07:05:19 EST,,0.0,10678.25,-3328700.0,372.87,20000.0,-9321.75
2,Paper,Paper,9276.925,USD,BITSTAMP,2.0,,,1.0,371.077,2.0,1.0,8653.075,BOT,BTC,USD,20160322 23:10:29 EST,,17930.0,19331.325,-3328700.0,371.077,37930.0,8653.075
3,Paper,Paper,9285.0,USD,BITSTAMP,3.0,,,1.0,371.4,2.0,-1.0,-6055.0,SLD,BTC,USD,20160322 23:12:24 EST,,3230.0,13276.325,-3328700.0,371.4,41160.0,-6055.0
4,Paper,Paper,9300.5,USD,BITSTAMP,4.0,,,1.0,372.02,2.0,1.0,-15500.5,BOT,BTC,USD,20160324 18:16:08 EST,,-6200.0,-2224.175,-3328700.0,372.02,34960.0,-15500.5
5,Paper,Paper,9315.5,USD,BITSTAMP,5.0,,,1.0,372.62,2.0,-1.0,-3315.5,SLD,BTC,USD,20160324 18:18:06 EST,,6000.0,-5539.675,-3328700.0,372.62,40960.0,-3315.5
6,Paper,Paper,9296.075,USD,BITSTAMP,6.0,,,1.0,371.843,2.0,1.0,-1526.075,BOT,BTC,USD,20160324 18:39:03 EST,,7770.0,-7065.75,-3328700.0,371.843,48730.0,-1526.075
7,Paper,Paper,9300.0,USD,BITSTAMP,7.0,,,1.0,372.0,2.0,-1.0,-7730.0,SLD,BTC,USD,20160324 18:40:26 EST,,1570.0,-14795.75,-3328700.0,372.0,50300.0,-7730.0
8,Paper,Paper,9299.975,USD,BITSTAMP,8.0,,,1.0,371.999,2.0,1.0,-9289.975,BOT,BTC,USD,20160324 18:45:24 EST,,9.99999999976,-24085.725,-3328700.0,371.999,50310.0,-9289.975
9,Paper,Paper,9300.0,USD,BITSTAMP,9.0,,,1.0,372.0,2.0,-1.0,-9290.0,SLD,BTC,USD,20160324 18:50:43 EST,,9.99999999976,-33375.725,-3328700.0,372.0,50320.0,-9290.0
10,Paper,Paper,9296.025,USD,BITSTAMP,10.0,,,1.0,371.841,2.0,1.0,-7706.025,BOT,BTC,USD,20160324 19:17:27 EST,,1590.0,-41081.75,-3328700.0,371.841,51910.0,-7706.025
11,Paper,Paper,9312.2,USD,BITSTAMP,11.0,,,1.0,372.488,2.0,-1.0,-2842.2,SLD,BTC,USD,20160324 19:20:28 EST,,6470.0,-43923.95,-3328700.0,372.488,58380.0,-2842.2
12,Paper,Paper,9298.0,USD,BITSTAMP,12.0,,,1.0,371.92,2.0,1.0,-3618.0,BOT,BTC,USD,20160324 19:23:51 EST,,5680.0,-47541.95,-3328700.0,371.92,64060.0,-3618.0
13,Paper,Paper,9291.5,USD,BITSTAMP,13.0,,,1.0,371.66,2.0,-1.0,-11891.5,SLD,BTC,USD,20160324 19:25:33 EST,,-2600.0,-59433.45,-3328700.0,371.66,61460.0,-11891.5
14,Paper,Paper,9289.425,USD,BITSTAMP,14.0,,,1.0,371.577,2.0,1.0,-8459.425,BOT,BTC,USD,20160324 20:00:41 EST,,830.0,-67892.875,-3328700.0,371.577,62290.0,-8459.425
15,Paper,Paper,9289.425,USD,BITSTAMP,15.0,,,1.0,371.577,2.0,-1.0,-9289.425,SLD,BTC,USD,20160324 20:02:23 EST,,0.0,-77182.3,-3328700.0,371.577,62290.0,-9289.425
16,Paper,Paper,9288.75,USD,BITSTAMP,16.0,,,1.0,371.55,2.0,1.0,-9018.75,BOT,BTC,USD,20160324 20:04:09 EST,,270.0,-86201.05,-3328700.0,371.55,62560.0,-9018.75
17,Paper,Paper,9304.7,USD,BITSTAMP,17.0,,,1.0,372.188,2.0,-1.0,-2924.7,SLD,BTC,USD,20160324 20:07:37 EST,,6380.0,-89125.75,-3328700.0,372.188,68940.0,-2924.7
18,Paper,Paper,9273.975,USD,BITSTAMP,18.0,,,1.0,370.959,2.0,1.0,3016.025,BOT,BTC,USD,20160324 20:46:34 EST,,12290.0,-86109.725,-3328700.0,370.959,81230.0,3016.025
19,Paper,Paper,9274.45,USD,BITSTAMP,19.0,,,1.0,370.978,2.0,-1.0,-9084.45,SLD,BTC,USD,20160324 20:48:18 EST,,190.0,-95194.175,-3328700.0,370.978,81420.0,-9084.45
20,Paper,Paper,9271.25,USD,BITSTAMP,20.0,,,1.0,370.85,2.0,1.0,-7991.25,BOT,BTC,USD,20160324 21:18:18 EST,,1280.0,-103185.425,-3328700.0,370.85,82700.0,-7991.25
21,Paper,Paper,9270.75,USD,BITSTAMP,21.0,,,1.0,370.83,2.0,-1.0,-9470.75,SLD,BTC,USD,20160324 21:20:03 EST,,-200.0,-112656.175,-3328700.0,370.83,82500.0,-9470.75
22,Paper,Paper,9267.175,USD,BITSTAMP,22.0,,,1.0,370.687,2.0,1.0,-7837.175,BOT,BTC,USD,20160324 21:25:47 EST,,1430.0,-120493.35,-3328700.0,370.687,83930.0,-7837.175
23,Paper,Paper,9287.225,USD,BITSTAMP,23.0,,,1.0,371.489,2.0,-1.0,-1267.225,SLD,BTC,USD,20160324 21:27:37 EST,,8020.0,-121760.575,-3328700.0,371.489,91950.0,-1267.225
24,Paper,Paper,9268.025,USD,BITSTAMP,24.0,,,1.0,370.721,2.0,1.0,-1588.025,BOT,BTC,USD,20160324 21:29:22 EST,,7680.0,-123348.6,-3328700.0,370.721,99630.0,-1588.025
25,Paper,Paper,9263.25,USD,BITSTAMP,25.0,,,1.0,370.53,2.0,-1.0,-11173.25,SLD,BTC,USD,20160324 21:34:57 EST,,-1910.0,-134521.85,-3328700.0,370.53,97720.0,-11173.25
26,Paper,Paper,9264.25,USD,BITSTAMP,26.0,,,1.0,370.57,2.0,1.0,-9664.25,BOT,BTC,USD,20160324 21:42:16 EST,,-400.0,-144186.1,-3328700.0,370.57,97320.0,-9664.25
27,Paper,Paper,9294.75,USD,BITSTAMP,27.0,,,1.0,371.79,2.0,-1.0,2905.25,SLD,BTC,USD,20160324 21:44:08 EST,,12200.0,-141280.85,-3328700.0,371.79,109520.0,2905.25
28,Paper,Paper,9279.75,USD,BITSTAMP,28.0,,,1.0,371.19,2.0,1.0,-3279.75,BOT,BTC,USD,20160324 21:58:54 EST,,6000.0,-144560.6,-3328700.0,371.19,115520.0,-3279.75
29,Paper,Paper,9299.675,USD,BITSTAMP,29.0,,,1.0,371.987,2.0,-1.0,-1329.675,SLD,BTC,USD,20160324 22:02:33 EST,,7970.0,-145890.275,-3328700.0,371.987,123490.0,-1329.675
30,Paper,Paper,9281.5,USD,BITSTAMP,30.0,,,1.0,371.26,2.0,1.0,-2011.5,BOT,BTC,USD,20160324 22:06:09 EST,,7270.0,-147901.775,-3328700.0,371.26,130760.0,-2011.5
31,Paper,Paper,9282.0,USD,BITSTAMP,31.0,,,1.0,371.28,2.0,-1.0,-9082.0,SLD,BTC,USD,20160324 22:07:58 EST,,200.0,-156983.775,-3328700.0,371.28,130960.0,-9082.0
32,Paper,Paper,9291.25,USD,BITSTAMP,32.0,,,1.0,371.65,2.0,1.0,-12991.25,BOT,BTC,USD,20160324 22:50:01 EST,,-3700.0,-169975.025,-3328700.0,371.65,127260.0,-12991.25
33,Paper,Paper,9295.0,USD,BITSTAMP,33.0,,,1.0,371.8,2.0,-1.0,-7795.0,SLD,BTC,USD,20160324 22:51:52 EST,,1500.0,-177770.025,-3328700.0,371.8,128760.0,-7795.0
34,Paper,Paper,9302.25,USD,BITSTAMP,34.0,,,1.0,372.09,2.0,1.0,-12202.25,BOT,BTC,USD,20160324 22:57:25 EST,,-2900.0,-189972.275,-3328700.0,372.09,125860.0,-12202.25
35,Paper,Paper,9302.0,USD,BITSTAMP,35.0,,,1.0,372.08,2.0,-1.0,-9402.0,SLD,BTC,USD,20160324 22:59:16 EST,,-99.9999999999,-199374.275,-3328700.0,372.08,125760.0,-9402.0
36,Paper,Paper,9306.0,USD,BITSTAMP,36.0,,,1.0,372.24,2.0,1.0,-10906.0,BOT,BTC,USD,20160324 23:08:18 EST,,-1600.0,-210280.275,-3328700.0,372.24,124160.0,-10906.0
37,Paper,Paper,9297.0,USD,BITSTAMP,37.0,,,1.0,371.88,2.0,-1.0,-12897.0,SLD,BTC,USD,20160324 23:11:10 EST,,-3600.0,-223177.275,-3328700.0,371.88,120560.0,-12897.0
38,Paper,Paper,9305.025,USD,BITSTAMP,38.0,,,1.0,372.201,2.0,1.0,-12515.025,BOT,BTC,USD,20160324 23:33:16 EST,,-3210.0,-235692.3,-3328700.0,372.201,117350.0,-12515.025
39,Paper,Paper,9322.825,USD,BITSTAMP,39.0,,,1.0,372.913,2.0,-1.0,-2202.825,SLD,BTC,USD,20160324 23:36:56 EST,,7120.0,-237895.125,-3328700.0,372.913,124470.0,-2202.825
40,Paper,Paper,9302.25,USD,BITSTAMP,40.0,,,1.0,372.09,2.0,1.0,-1072.25,BOT,BTC,USD,20160324 23:38:47 EST,,8230.0,-238967.375,-3328700.0,372.09,132700.0,-1072.25
41,Paper,Paper,9302.25,USD,BITSTAMP,41.0,,,1.0,372.09,2.0,-1.0,-9302.25,SLD,BTC,USD,20160324 23:42:32 EST,,0.0,-248269.625,-3328700.0,372.09,132700.0,-9302.25
42,Paper,Paper,9299.0,USD,BITSTAMP,42.0,,,1.0,371.96,2.0,1.0,-7999.0,BOT,BTC,USD,20160324 23:55:34 EST,,1300.0,-256268.625,-3328700.0,371.96,134000.0,-7999.0
43,Paper,Paper,9316.025,USD,BITSTAMP,43.0,,,1.0,372.641,2.0,-1.0,-2506.025,SLD,BTC,USD,20160324 23:57:27 EST,,6810.0,-258774.65,-3328700.0,372.641,140810.0,-2506.025
44,Paper,Paper,9299.975,USD,BITSTAMP,44.0,,,1.0,371.999,2.0,1.0,-2879.975,BOT,BTC,USD,20160325 00:32:15 EST,,6420.0,-261654.625,-3328700.0,371.999,147230.0,-2879.975
45,Paper,Paper,9309.25,USD,BITSTAMP,45.0,,,1.0,372.37,2.0,-1.0,-5599.25,SLD,BTC,USD,20160325 00:34:07 EST,,3710.0,-267253.875,-3328700.0,372.37,150940.0,-5599.25
46,Paper,Paper,9299.975,USD,BITSTAMP,46.0,,,1.0,371.999,2.0,1.0,-5589.975,BOT,BTC,USD,20160325 00:35:47 EST,,3710.0,-272843.85,-3328700.0,371.999,154650.0,-5589.975
47,Paper,Paper,9309.0,USD,BITSTAMP,47.0,,,1.0,372.36,2.0,-1.0,-5699.0,SLD,BTC,USD,20160325 00:37:39 EST,,3610.0,-278542.85,-3328700.0,372.36,158260.0,-5699.0
48,Paper,Paper,9299.975,USD,BITSTAMP,48.0,,,1.0,371.999,2.0,1.0,-5689.975,BOT,BTC,USD,20160325 00:39:32 EST,,3610.0,-284232.825,-3328700.0,371.999,161870.0,-5689.975
49,Paper,Paper,9309.5,USD,BITSTAMP,49.0,,,1.0,372.38,2.0,-1.0,-5499.5,SLD,BTC,USD,20160325 00:41:27 EST,,3810.0,-289732.325,-3328700.0,372.38,165680.0,-5499.5
50,Paper,Paper,9321.4,USD,BITSTAMP,50.0,,,1.0,372.856,2.0,1.0,-14081.4,BOT,BTC,USD,20160325 01:07:34 EST,,-4760.0,-303813.725,-3328700.0,372.856,160920.0,-14081.4
51,Paper,Paper,9321.75,USD,BITSTAMP,51.0,,,1.0,372.87,2.0,-1.0,-9181.75,SLD,BTC,USD,20160325 01:13:11 EST,,140.0,-312995.475,-3328700.0,372.87,161060.0,-9181.75
52,Paper,Paper,9305.025,USD,BITSTAMP,52.0,,,1.0,372.201,2.0,1.0,-2615.025,BOT,BTC,USD,20160325 01:20:30 EST,,6690.0,-315610.5,-3328700.0,372.201,167750.0,-2615.025
53,Paper,Paper,9305.0,USD,BITSTAMP,53.0,,,1.0,372.2,2.0,-1.0,-9315.0,SLD,BTC,USD,20160325 01:24:21 EST,,-9.99999999976,-324925.5,-3328700.0,372.2,167740.0,-9315.0
54,Paper,Paper,9285.25,USD,BITSTAMP,54.0,,,1.0,371.41,2.0,1.0,-1385.25,BOT,BTC,USD,20160325 01:41:13 EST,,7900.0,-326310.75,-3328700.0,371.41,175640.0,-1385.25
55,Paper,Paper,9322.875,USD,BITSTAMP,55.0,,,1.0,372.915,2.0,-1.0,5727.125,SLD,BTC,USD,20160325 01:45:02 EST,,15050.0,-320583.625,-3328700.0,372.915,190690.0,5727.125
56,Paper,Paper,9324.475,USD,BITSTAMP,56.0,,,1.0,372.979,2.0,1.0,-9964.475,BOT,BTC,USD,20160325 01:58:09 EST,,-640.0,-330548.1,-3328700.0,372.979,190050.0,-9964.475
57,Paper,Paper,9297.75,USD,BITSTAMP,57.0,,,1.0,371.91,2.0,-1.0,-19987.75,SLD,BTC,USD,20160325 02:00:04 EST,,-10690.0,-350535.85,-3328700.0,371.91,179360.0,-19987.75
58,Paper,Paper,9296.0,USD,BITSTAMP,58.0,,,1.0,371.84,2.0,1.0,-8596.0,BOT,BTC,USD,20160325 02:15:31 EST,,700.000000001,-359131.85,-3328700.0,371.84,180060.0,-8596.0
59,Paper,Paper,9298.5,USD,BITSTAMP,59.0,,,1.0,371.94,2.0,-1.0,-8298.5,SLD,BTC,USD,20160325 02:17:23 EST,,1000.0,-367430.35,-3328700.0,371.94,181060.0,-8298.5
60,Paper,Paper,9298.75,USD,BITSTAMP,60.0,,,1.0,371.95,2.0,1.0,-9398.75,BOT,BTC,USD,20160325 02:19:16 EST,,-99.9999999999,-376829.1,-3328700.0,371.95,180960.0,-9398.75
61,Paper,Paper,9299.0,USD,BITSTAMP,61.0,,,1.0,371.96,2.0,-1.0,-9199.0,SLD,BTC,USD,20160325 02:20:56 EST,,99.9999999999,-386028.1,-3328700.0,371.96,181060.0,-9199.0
62,Paper,Paper,9299.25,USD,BITSTAMP,62.0,,,1.0,371.97,2.0,1.0,-9399.25,BOT,BTC,USD,20160325 02:22:35 EST,,-100.0,-395427.35,-3328700.0,371.97,180960.0,-9399.25
63,Paper,Paper,9299.75,USD,BITSTAMP,63.0,,,1.0,371.99,2.0,-1.0,-9099.75,SLD,BTC,USD,20160325 02:24:34 EST,,200.0,-404527.1,-3328700.0,371.99,181160.0,-9099.75
64,Paper,Paper,9309.225,USD,BITSTAMP,64.0,,,1.0,372.369,2.0,1.0,-13099.225,BOT,BTC,USD,20160325 02:44:44 EST,,-3790.0,-417626.325,-3328700.0,372.369,177370.0,-13099.225
65,Paper,Paper,9299.75,USD,BITSTAMP,65.0,,,1.0,371.99,2.0,-1.0,-13089.75,SLD,BTC,USD,20160325 02:50:04 EST,,-3790.0,-430716.075,-3328700.0,371.99,173580.0,-13089.75
66,Paper,Paper,9278.75,USD,BITSTAMP,66.0,,,1.0,371.15,2.0,1.0,-878.75,BOT,BTC,USD,20160325 02:55:49 EST,,8400.0,-431594.825,-3328700.0,371.15,181980.0,-878.75
67,Paper,Paper,9305.225,USD,BITSTAMP,67.0,,,1.0,372.209,2.0,-1.0,1284.775,SLD,BTC,USD,20160325 03:01:40 EST,,10590.0,-430310.05,-3328700.0,372.209,192570.0,1284.775
68,Paper,Paper,9332.5,USD,BITSTAMP,68.0,,,1.0,373.3,2.0,1.0,-20242.5,BOT,BTC,USD,20160325 03:42:22 EST,,-10910.0,-450552.55,-3328700.0,373.3,181660.0,-20242.5
69,Paper,Paper,9332.5,USD,BITSTAMP,69.0,,,1.0,373.3,2.0,-1.0,-9332.5,SLD,BTC,USD,20160325 03:44:21 EST,,0.0,-459885.05,-3328700.0,373.3,181660.0,-9332.5
70,Paper,Paper,9324.5,USD,BITSTAMP,70.0,,,1.0,372.98,2.0,1.0,-6124.5,BOT,BTC,USD,20160325 03:46:20 EST,,3200.0,-466009.55,-3328700.0,372.98,184860.0,-6124.5
71,Paper,Paper,9332.5,USD,BITSTAMP,71.0,,,1.0,373.3,2.0,-1.0,-6132.5,SLD,BTC,USD,20160325 03:48:17 EST,,3200.0,-472142.05,-3328700.0,373.3,188060.0,-6132.5
72,Paper,Paper,9319.25,USD,BITSTAMP,72.0,,,1.0,372.77,2.0,1.0,-4019.25,BOT,BTC,USD,20160325 04:08:04 EST,,5300.0,-476161.3,-3328700.0,372.77,193360.0,-4019.25
73,Paper,Paper,9332.25,USD,BITSTAMP,73.0,,,1.0,373.29,2.0,-1.0,-4132.25,SLD,BTC,USD,20160325 04:09:55 EST,,5200.0,-480293.55,-3328700.0,373.29,198560.0,-4132.25
74,Paper,Paper,9321.5,USD,BITSTAMP,74.0,,,1.0,372.86,2.0,1.0,-5021.5,BOT,BTC,USD,20160325 04:14:58 EST,,4300.0,-485315.05,-3328700.0,372.86,202860.0,-5021.5
75,Paper,Paper,9349.75,USD,BITSTAMP,75.0,,,1.0,373.99,2.0,-1.0,1950.25,SLD,BTC,USD,20160325 04:16:48 EST,,11300.0,-483364.8,-3328700.0,373.99,214160.0,1950.25
76,Paper,Paper,9350.475,USD,BITSTAMP,76.0,,,1.0,374.019,2.0,1.0,-9640.475,BOT,BTC,USD,20160325 04:23:46 EST,,-290.0,-493005.275,-3328700.0,374.019,213870.0,-9640.475
77,Paper,Paper,9347.725,USD,BITSTAMP,77.0,,,1.0,373.909,2.0,-1.0,-10447.725,SLD,BTC,USD,20160325 04:25:38 EST,,-1100.0,-503453.0,-3328700.0,373.909,212770.0,-10447.725
78,Paper,Paper,9327.225,USD,BITSTAMP,78.0,,,1.0,373.089,2.0,1.0,-1127.225,BOT,BTC,USD,20160325 04:36:00 EST,,8200.0,-504580.225,-3328700.0,373.089,220970.0,-1127.225
79,Paper,Paper,9326.5,USD,BITSTAMP,79.0,,,1.0,373.06,2.0,-1.0,-9616.5,SLD,BTC,USD,20160325 04:37:50 EST,,-290.0,-514196.725,-3328700.0,373.06,220680.0,-9616.5
80,Paper,Paper,9321.225,USD,BITSTAMP,80.0,,,1.0,372.849,2.0,1.0,-7211.225,BOT,BTC,USD,20160325 04:41:30 EST,,2110.0,-521407.95,-3328700.0,372.849,222790.0,-7211.225
81,Paper,Paper,9321.5,USD,BITSTAMP,81.0,,,1.0,372.86,2.0,-1.0,-9211.5,SLD,BTC,USD,20160325 04:43:20 EST,,110.0,-530619.45,-3328700.0,372.86,222900.0,-9211.5
82,Paper,Paper,9302.75,USD,BITSTAMP,82.0,,,1.0,372.11,2.0,1.0,-1802.75,BOT,BTC,USD,20160325 04:50:34 EST,,7500.0,-532422.2,-3328700.0,372.11,230400.0,-1802.75
83,Paper,Paper,9295.275,USD,BITSTAMP,83.0,,,1.0,371.811,2.0,-1.0,-12285.275,SLD,BTC,USD,20160325 04:52:26 EST,,-2990.0,-544707.475,-3328700.0,371.811,227410.0,-12285.275
84,Paper,Paper,9295.275,USD,BITSTAMP,84.0,,,1.0,371.811,2.0,1.0,-9295.275,BOT,BTC,USD,20160325 04:54:17 EST,,0.0,-554002.75,-3328700.0,371.811,227410.0,-9295.275
85,Paper,Paper,9317.0,USD,BITSTAMP,85.0,,,1.0,372.68,2.0,-1.0,-627.0,SLD,BTC,USD,20160325 04:56:07 EST,,8690.0,-554629.75,-3328700.0,372.68,236100.0,-627.0
86,Paper,Paper,9322.0,USD,BITSTAMP,86.0,,,1.0,372.88,2.0,1.0,-11322.0,BOT,BTC,USD,20160325 05:19:48 EST,,-2000.0,-565951.75,-3328700.0,372.88,234100.0,-11322.0
87,Paper,Paper,9321.3,USD,BITSTAMP,87.0,,,1.0,372.852,2.0,-1.0,-9601.3,SLD,BTC,USD,20160325 05:21:24 EST,,-280.0,-575553.05,-3328700.0,372.852,233820.0,-9601.3
88,Paper,Paper,9322.3,USD,BITSTAMP,88.0,,,1.0,372.892,2.0,1.0,-9722.3,BOT,BTC,USD,20160325 05:42:15 EST,,-400.0,-585275.35,-3328700.0,372.892,233420.0,-9722.3
89,Paper,Paper,9325.0,USD,BITSTAMP,89.0,,,1.0,373.0,2.0,-1.0,-8245.0,SLD,BTC,USD,20160325 05:43:54 EST,,1080.0,-593520.35,-3328700.0,373.0,234500.0,-8245.0
90,Paper,Paper,9322.3,USD,BITSTAMP,90.0,,,1.0,372.892,2.0,1.0,-8242.3,BOT,BTC,USD,20160325 05:48:59 EST,,1080.0,-601762.65,-3328700.0,372.892,235580.0,-8242.3
91,Paper,Paper,9326.725,USD,BITSTAMP,91.0,,,1.0,373.069,2.0,-1.0,-7556.725,SLD,BTC,USD,20160325 05:50:42 EST,,1770.0,-609319.375,-3328700.0,373.069,237350.0,-7556.725
92,Paper,Paper,9324.0,USD,BITSTAMP,92.0,,,1.0,372.96,2.0,1.0,-8234.0,BOT,BTC,USD,20160325 06:02:43 EST,,1090.0,-617553.375,-3328700.0,372.96,238440.0,-8234.0
93,Paper,Paper,9324.0,USD,BITSTAMP,93.0,,,1.0,372.96,2.0,-1.0,-9324.0,SLD,BTC,USD,20160325 06:04:32 EST,,0.0,-626877.375,-3328700.0,372.96,238440.0,-9324.0
94,Paper,Paper,9325.0,USD,BITSTAMP,94.0,,,1.0,373.0,2.0,1.0,-9725.0,BOT,BTC,USD,20160325 06:11:41 EST,,-400.0,-636602.375,-3328700.0,373.0,238040.0,-9725.0
95,Paper,Paper,9337.75,USD,BITSTAMP,95.0,,,1.0,373.51,2.0,-1.0,-4237.75,SLD,BTC,USD,20160325 06:13:33 EST,,5100.0,-640840.125,-3328700.0,373.51,243140.0,-4237.75
96,Paper,Paper,9322.425,USD,BITSTAMP,96.0,,,1.0,372.897,2.0,1.0,-3192.425,BOT,BTC,USD,20160325 06:29:16 EST,,6130.0,-644032.55,-3328700.0,372.897,249270.0,-3192.425
97,Paper,Paper,9324.75,USD,BITSTAMP,97.0,,,1.0,372.99,2.0,-1.0,-8394.75,SLD,BTC,USD,20160325 06:31:09 EST,,930.0,-652427.3,-3328700.0,372.99,250200.0,-8394.75
98,Paper,Paper,9315.5,USD,BITSTAMP,98.0,,,1.0,372.62,2.0,1.0,-5615.5,BOT,BTC,USD,20160325 06:42:07 EST,,3700.0,-658042.8,-3328700.0,372.62,253900.0,-5615.5
99,Paper,Paper,9317.5,USD,BITSTAMP,99.0,,,1.0,372.7,2.0,-1.0,-8517.5,SLD,BTC,USD,20160325 06:45:36 EST,,800.0,-666560.3,-3328700.0,372.7,254700.0,-8517.5
100,Paper,Paper,9319.925,USD,BITSTAMP,100.0,,,1.0,372.797,2.0,1.0,-10289.925,BOT,BTC,USD,20160325 07:09:46 EST,,-970.0,-676850.225,-3328700.0,372.797,253730.0,-10289.925
101,Paper,Paper,9337.5,USD,BITSTAMP,101.0,,,1.0,373.5,2.0,-1.0,-2307.5,SLD,BTC,USD,20160325 07:14:55 EST,,7030.0,-679157.725,-3328700.0,373.5,260760.0,-2307.5
102,Paper,Paper,9339.5,USD,BITSTAMP,102.0,,,1.0,373.58,2.0,1.0,-10139.5,BOT,BTC,USD,20160325 07:44:17 EST,,-800.0,-689297.225,-3328700.0,373.58,259960.0,-10139.5
103,Paper,Paper,9337.475,USD,BITSTAMP,103.0,,,1.0,373.499,2.0,-1.0,-10147.475,SLD,BTC,USD,20160325 07:46:09 EST,,-810.0,-699444.7,-3328700.0,373.499,259150.0,-10147.475
104,Paper,Paper,9346.0,USD,BITSTAMP,104.0,,,1.0,373.84,2.0,1.0,-12756.0,BOT,BTC,USD,20160325 09:09:44 EST,,-3410.0,-712200.7,-3328700.0,373.84,255740.0,-12756.0
105,Paper,Paper,9348.5,USD,BITSTAMP,105.0,,,1.0,373.94,2.0,-1.0,-8348.5,SLD,BTC,USD,20160325 09:12:45 EST,,1000.0,-720549.2,-3328700.0,373.94,256740.0,-8348.5
106,Paper,Paper,9330.55,USD,BITSTAMP,106.0,,,1.0,373.222,2.0,1.0,-2150.55,BOT,BTC,USD,20160325 09:29:07 EST,,7180.0,-722699.75,-3328700.0,373.222,263920.0,-2150.55
107,Paper,Paper,9338.0,USD,BITSTAMP,107.0,,,1.0,373.52,2.0,-1.0,-6358.0,SLD,BTC,USD,20160325 09:30:45 EST,,2980.0,-729057.75,-3328700.0,373.52,266900.0,-6358.0
108,Paper,Paper,9337.45,USD,BITSTAMP,108.0,,,1.0,373.498,2.0,1.0,-9117.45,BOT,BTC,USD,20160325 09:52:14 EST,,220.0,-738175.2,-3328700.0,373.498,267120.0,-9117.45
109,Paper,Paper,9333.25,USD,BITSTAMP,109.0,,,1.0,373.33,2.0,-1.0,-11013.25,SLD,BTC,USD,20160325 09:57:08 EST,,-1680.0,-749188.45,-3328700.0,373.33,265440.0,-11013.25
110,Paper,Paper,9343.475,USD,BITSTAMP,110.0,,,1.0,373.739,2.0,1.0,-13433.475,BOT,BTC,USD,20160325 10:10:13 EST,,-4090.0,-762621.925,-3328700.0,373.739,261350.0,-13433.475
111,Paper,Paper,9343.0,USD,BITSTAMP,111.0,,,1.0,373.72,2.0,-1.0,-9533.0,SLD,BTC,USD,20160325 10:13:29 EST,,-190.0,-772154.925,-3328700.0,373.72,261160.0,-9533.0
112,Paper,Paper,9334.025,USD,BITSTAMP,112.0,,,1.0,373.361,2.0,1.0,-5744.025,BOT,BTC,USD,20160325 11:05:07 EST,,3590.0,-777898.95,-3328700.0,373.361,264750.0,-5744.025
113,Paper,Paper,9318.375,USD,BITSTAMP,113.0,,,1.0,372.735,2.0,-1.0,-15578.375,SLD,BTC,USD,20160325 11:06:50 EST,,-6260.0,-793477.325,-3328700.0,372.735,258490.0,-15578.375
114,Paper,Paper,9339.5,USD,BITSTAMP,114.0,,,1.0,373.58,2.0,1.0,-17789.5,BOT,BTC,USD,20160325 11:33:58 EST,,-8450.0,-811266.825,-3328700.0,373.58,250040.0,-17789.5
115,Paper,Paper,9343.975,USD,BITSTAMP,115.0,,,1.0,373.759,2.0,-1.0,-7553.975,SLD,BTC,USD,20160325 11:35:38 EST,,1790.0,-818820.8,-3328700.0,373.759,251830.0,-7553.975
116,Paper,Paper,9344.975,USD,BITSTAMP,116.0,,,1.0,373.799,2.0,1.0,-9744.975,BOT,BTC,USD,20160325 11:59:26 EST,,-400.0,-828565.775,-3328700.0,373.799,251430.0,-9744.975
117,Paper,Paper,9341.25,USD,BITSTAMP,117.0,,,1.0,373.65,2.0,-1.0,-10831.25,SLD,BTC,USD,20160325 12:01:05 EST,,-1490.0,-839397.025,-3328700.0,373.65,249940.0,-10831.25
118,Paper,Paper,9340.5,USD,BITSTAMP,118.0,,,1.0,373.62,2.0,1.0,-9040.5,BOT,BTC,USD,20160325 12:02:45 EST,,300.0,-848437.525,-3328700.0,373.62,250240.0,-9040.5
119,Paper,Paper,9340.25,USD,BITSTAMP,119.0,,,1.0,373.61,2.0,-1.0,-9440.25,SLD,BTC,USD,20160325 12:04:28 EST,,-99.9999999999,-857877.775,-3328700.0,373.61,250140.0,-9440.25
120,Paper,Paper,9345.975,USD,BITSTAMP,120.0,,,1.0,373.839,2.0,1.0,-11635.975,BOT,BTC,USD,20160325 12:23:38 EST,,-2290.0,-869513.75,-3328700.0,373.839,247850.0,-11635.975
121,Paper,Paper,9345.75,USD,BITSTAMP,121.0,,,1.0,373.83,2.0,-1.0,-9435.75,SLD,BTC,USD,20160325 12:27:08 EST,,-90.0000000001,-878949.5,-3328700.0,373.83,247760.0,-9435.75
122,Paper,Paper,9332.25,USD,BITSTAMP,122.0,,,1.0,373.29,2.0,1.0,-3932.25,BOT,BTC,USD,20160325 12:35:56 EST,,5400.0,-882881.75,-3328700.0,373.29,253160.0,-3932.25
123,Paper,Paper,9345.0,USD,BITSTAMP,123.0,,,1.0,373.8,2.0,-1.0,-4245.0,SLD,BTC,USD,20160325 12:37:41 EST,,5100.0,-887126.75,-3328700.0,373.8,258260.0,-4245.0
124,Paper,Paper,9355.0,USD,BITSTAMP,124.0,,,1.0,374.2,2.0,1.0,-13355.0,BOT,BTC,USD,20160325 13:18:05 EST,,-4000.0,-900481.75,-3328700.0,374.2,254260.0,-13355.0
125,Paper,Paper,9355.0,USD,BITSTAMP,125.0,,,1.0,374.2,2.0,-1.0,-9355.0,SLD,BTC,USD,20160325 13:19:56 EST,,0.0,-909836.75,-3328700.0,374.2,254260.0,-9355.0
126,Paper,Paper,9342.8,USD,BITSTAMP,126.0,,,1.0,373.712,2.0,1.0,-4462.8,BOT,BTC,USD,20160325 13:21:43 EST,,4880.0,-914299.55,-3328700.0,373.712,259140.0,-4462.8
127,Paper,Paper,9350.0,USD,BITSTAMP,127.0,,,1.0,374.0,2.0,-1.0,-6470.0,SLD,BTC,USD,20160325 13:23:29 EST,,2880.0,-920769.55,-3328700.0,374.0,262020.0,-6470.0
128,Paper,Paper,9343.75,USD,BITSTAMP,128.0,,,1.0,373.75,2.0,1.0,-6843.75,BOT,BTC,USD,20160325 14:01:01 EST,,2500.0,-927613.3,-3328700.0,373.75,264520.0,-6843.75
129,Paper,Paper,9343.75,USD,BITSTAMP,129.0,,,1.0,373.75,2.0,-1.0,-9343.75,SLD,BTC,USD,20160325 14:02:48 EST,,0.0,-936957.05,-3328700.0,373.75,264520.0,-9343.75
130,Paper,Paper,9342.5,USD,BITSTAMP,130.0,,,1.0,373.7,2.0,1.0,-8842.5,BOT,BTC,USD,20160325 14:08:24 EST,,500.0,-945799.55,-3328700.0,373.7,265020.0,-8842.5
131,Paper,Paper,9342.5,USD,BITSTAMP,131.0,,,1.0,373.7,2.0,-1.0,-9342.5,SLD,BTC,USD,20160325 14:10:11 EST,,0.0,-955142.05,-3328700.0,373.7,265020.0,-9342.5
132,Paper,Paper,9324.0,USD,BITSTAMP,132.0,,,1.0,372.96,2.0,1.0,-1924.0,BOT,BTC,USD,20160325 14:19:10 EST,,7400.0,-957066.05,-3328700.0,372.96,272420.0,-1924.0
133,Paper,Paper,9324.0,USD,BITSTAMP,133.0,,,1.0,372.96,2.0,-1.0,-9324.0,SLD,BTC,USD,20160325 14:20:58 EST,,0.0,-966390.05,-3328700.0,372.96,272420.0,-9324.0
134,Paper,Paper,9324.0,USD,BITSTAMP,134.0,,,1.0,372.96,2.0,1.0,-9324.0,BOT,BTC,USD,20160325 14:24:40 EST,,0.0,-975714.05,-3328700.0,372.96,272420.0,-9324.0
135,Paper,Paper,9338.225,USD,BITSTAMP,135.0,,,1.0,373.529,2.0,-1.0,-3648.225,SLD,BTC,USD,20160325 14:26:27 EST,,5690.0,-979362.275,-3328700.0,373.529,278110.0,-3648.225
136,Paper,Paper,9324.25,USD,BITSTAMP,136.0,,,1.0,372.97,2.0,1.0,-3734.25,BOT,BTC,USD,20160325 14:55:43 EST,,5590.0,-983096.525,-3328700.0,372.97,283700.0,-3734.25
137,Paper,Paper,9342.225,USD,BITSTAMP,137.0,,,1.0,373.689,2.0,-1.0,-2152.225,SLD,BTC,USD,20160325 14:57:33 EST,,7190.0,-985248.75,-3328700.0,373.689,290890.0,-2152.225
138,Paper,Paper,9335.0,USD,BITSTAMP,138.0,,,1.0,373.4,2.0,1.0,-6445.0,BOT,BTC,USD,20160325 15:15:49 EST,,2890.0,-991693.75,-3328700.0,373.4,293780.0,-6445.0
139,Paper,Paper,9335.0,USD,BITSTAMP,139.0,,,1.0,373.4,2.0,-1.0,-9335.0,SLD,BTC,USD,20160325 15:17:39 EST,,0.0,-1001028.75,-3328700.0,373.4,293780.0,-9335.0
140,Paper,Paper,9334.975,USD,BITSTAMP,140.0,,,1.0,373.399,2.0,1.0,-9324.975,BOT,BTC,USD,20160325 15:47:11 EST,,9.99999999976,-1010353.725,-3328700.0,373.399,293790.0,-9324.975
141,Paper,Paper,9320.25,USD,BITSTAMP,141.0,,,1.0,372.81,2.0,-1.0,-15210.25,SLD,BTC,USD,20160325 15:52:54 EST,,-5890.0,-1025563.975,-3328700.0,372.81,287900.0,-15210.25
142,Paper,Paper,9321.75,USD,BITSTAMP,142.0,,,1.0,372.87,2.0,1.0,-9921.75,BOT,BTC,USD,20160325 15:56:33 EST,,-600.0,-1035485.725,-3328700.0,372.87,287300.0,-9921.75
143,Paper,Paper,9332.475,USD,BITSTAMP,143.0,,,1.0,373.299,2.0,-1.0,-5042.475,SLD,BTC,USD,20160325 15:58:28 EST,,4290.0,-1040528.2,-3328700.0,373.299,291590.0,-5042.475
144,Paper,Paper,9323.125,USD,BITSTAMP,144.0,,,1.0,372.925,2.0,1.0,-5583.125,BOT,BTC,USD,20160325 16:00:17 EST,,3740.0,-1046111.325,-3328700.0,372.925,295330.0,-5583.125
145,Paper,Paper,9332.5,USD,BITSTAMP,145.0,,,1.0,373.3,2.0,-1.0,-5582.5,SLD,BTC,USD,20160325 16:02:08 EST,,3750.0,-1051693.825,-3328700.0,373.3,299080.0,-5582.5
146,Paper,Paper,9319.75,USD,BITSTAMP,146.0,,,1.0,372.79,2.0,1.0,-4219.75,BOT,BTC,USD,20160325 16:28:12 EST,,5100.0,-1055913.575,-3328700.0,372.79,304180.0,-4219.75
147,Paper,Paper,9332.525,USD,BITSTAMP,147.0,,,1.0,373.301,2.0,-1.0,-4222.525,SLD,BTC,USD,20160325 16:30:04 EST,,5110.0,-1060136.1,-3328700.0,373.301,309290.0,-4222.525
148,Paper,Paper,9308.25,USD,BITSTAMP,148.0,,,1.0,372.33,2.0,1.0,401.75,BOT,BTC,USD,20160325 16:52:54 EST,,9710.0,-1059734.35,-3328700.0,372.33,319000.0,401.75
149,Paper,Paper,9308.75,USD,BITSTAMP,149.0,,,1.0,372.35,2.0,-1.0,-9108.75,SLD,BTC,USD,20160325 16:54:45 EST,,200.0,-1068843.1,-3328700.0,372.35,319200.0,-9108.75
150,Paper,Paper,9319.25,USD,BITSTAMP,150.0,,,1.0,372.77,2.0,1.0,-13519.25,BOT,BTC,USD,20160325 17:13:13 EST,,-4200.0,-1082362.35,-3328700.0,372.77,315000.0,-13519.25
151,Paper,Paper,9339.3,USD,BITSTAMP,151.0,,,1.0,373.572,2.0,-1.0,-1319.3,SLD,BTC,USD,20160325 17:20:37 EST,,8020.0,-1083681.65,-3328700.0,373.572,323020.0,-1319.3
152,Paper,Paper,9337.475,USD,BITSTAMP,152.0,,,1.0,373.499,2.0,1.0,-8607.475,BOT,BTC,USD,20160325 17:22:28 EST,,729.999999999,-1092289.125,-3328700.0,373.499,323750.0,-8607.475
153,Paper,Paper,9337.475,USD,BITSTAMP,153.0,,,1.0,373.499,2.0,-1.0,-9337.475,SLD,BTC,USD,20160325 17:24:17 EST,,0.0,-1101626.6,-3328700.0,373.499,323750.0,-9337.475
154,Paper,Paper,9324.975,USD,BITSTAMP,154.0,,,1.0,372.999,2.0,1.0,-4324.975,BOT,BTC,USD,20160325 18:31:44 EST,,5000.0,-1105951.575,-3328700.0,372.999,328750.0,-4324.975
155,Paper,Paper,9324.95,USD,BITSTAMP,155.0,,,1.0,372.998,2.0,-1.0,-9334.95,SLD,BTC,USD,20160325 18:33:40 EST,,-10.0000000003,-1115286.525,-3328700.0,372.998,328740.0,-9334.95
156,Paper,Paper,9327.925,USD,BITSTAMP,156.0,,,1.0,373.117,2.0,1.0,-10517.925,BOT,BTC,USD,20160325 19:05:35 EST,,-1190.0,-1125804.45,-3328700.0,373.117,327550.0,-10517.925
157,Paper,Paper,9332.65,USD,BITSTAMP,157.0,,,1.0,373.306,2.0,-1.0,-7442.65,SLD,BTC,USD,20160325 19:09:38 EST,,1890.0,-1133247.1,-3328700.0,373.306,329440.0,-7442.65
158,Paper,Paper,9325.25,USD,BITSTAMP,158.0,,,1.0,373.01,2.0,1.0,-6365.25,BOT,BTC,USD,20160325 19:21:35 EST,,2960.0,-1139612.35,-3328700.0,373.01,332400.0,-6365.25
159,Paper,Paper,9324.25,USD,BITSTAMP,159.0,,,1.0,372.97,2.0,-1.0,-9724.25,SLD,BTC,USD,20160325 19:29:29 EST,,-400.0,-1149336.6,-3328700.0,372.97,332000.0,-9724.25
160,Paper,Paper,9320.25,USD,BITSTAMP,160.0,,,1.0,372.81,2.0,1.0,-7720.25,BOT,BTC,USD,20160325 20:04:36 EST,,1600.0,-1157056.85,-3328700.0,372.81,333600.0,-7720.25
161,Paper,Paper,9318.55,USD,BITSTAMP,161.0,,,1.0,372.742,2.0,-1.0,-9998.55,SLD,BTC,USD,20160325 20:08:38 EST,,-680.0,-1167055.4,-3328700.0,372.742,332920.0,-9998.55
162,Paper,Paper,9342.225,USD,BITSTAMP,162.0,,,1.0,373.689,2.0,1.0,-18812.225,BOT,BTC,USD,20160325 20:24:23 EST,,-9470.0,-1185867.625,-3328700.0,373.689,323450.0,-18812.225
163,Paper,Paper,9344.35,USD,BITSTAMP,163.0,,,1.0,373.774,2.0,-1.0,-8494.35,SLD,BTC,USD,20160325 20:28:19 EST,,850.0,-1194361.975,-3328700.0,373.774,324300.0,-8494.35
164,Paper,Paper,9330.0,USD,BITSTAMP,164.0,,,1.0,373.2,2.0,1.0,-3590.0,BOT,BTC,USD,20160325 20:52:26 EST,,5740.0,-1197951.975,-3328700.0,373.2,330040.0,-3590.0
165,Paper,Paper,9341.25,USD,BITSTAMP,165.0,,,1.0,373.65,2.0,-1.0,-4841.25,SLD,BTC,USD,20160325 21:00:23 EST,,4500.0,-1202793.225,-3328700.0,373.65,334540.0,-4841.25
166,Paper,Paper,9351.15,USD,BITSTAMP,166.0,,,1.0,374.046,2.0,1.0,-13311.15,BOT,BTC,USD,20160325 22:41:39 EST,,-3960.0,-1216104.375,-3328700.0,374.046,330580.0,-13311.15
167,Paper,Paper,9361.4,USD,BITSTAMP,167.0,,,1.0,374.456,2.0,-1.0,-5261.4,SLD,BTC,USD,20160325 22:45:47 EST,,4100.0,-1221365.775,-3328700.0,374.456,334680.0,-5261.4
168,Paper,Paper,9350.0,USD,BITSTAMP,168.0,,,1.0,374.0,2.0,1.0,-4790.0,BOT,BTC,USD,20160325 23:06:38 EST,,4560.0,-1226155.775,-3328700.0,374.0,339240.0,-4790.0
169,Paper,Paper,9350.0,USD,BITSTAMP,169.0,,,1.0,374.0,2.0,-1.0,-9350.0,SLD,BTC,USD,20160325 23:10:47 EST,,0.0,-1235505.775,-3328700.0,374.0,339240.0,-9350.0
170,Paper,Paper,9352.0,USD,BITSTAMP,170.0,,,1.0,374.08,2.0,1.0,-10152.0,BOT,BTC,USD,20160325 23:14:51 EST,,-800.0,-1245657.775,-3328700.0,374.08,338440.0,-10152.0
171,Paper,Paper,9358.125,USD,BITSTAMP,171.0,,,1.0,374.325,2.0,-1.0,-6908.125,SLD,BTC,USD,20160325 23:23:10 EST,,2450.0,-1252565.9,-3328700.0,374.325,340890.0,-6908.125
172,Paper,Paper,9346.025,USD,BITSTAMP,172.0,,,1.0,373.841,2.0,1.0,-4506.025,BOT,BTC,USD,20160326 00:05:12 EST,,4840.0,-1257071.925,-3328700.0,373.841,345730.0,-4506.025
173,Paper,Paper,9340.0,USD,BITSTAMP,173.0,,,1.0,373.6,2.0,-1.0,-11750.0,SLD,BTC,USD,20160326 00:25:44 EST,,-2410.0,-1268821.925,-3328700.0,373.6,343320.0,-11750.0
174,Paper,Paper,9345.25,USD,BITSTAMP,174.0,,,1.0,373.81,2.0,1.0,-11445.25,BOT,BTC,USD,20160326 00:51:27 EST,,-2100.0,-1280267.175,-3328700.0,373.81,341220.0,-11445.25
175,Paper,Paper,9347.0,USD,BITSTAMP,175.0,,,1.0,373.88,2.0,-1.0,-8647.0,SLD,BTC,USD,20160326 00:54:51 EST,,700.0,-1288914.175,-3328700.0,373.88,341920.0,-8647.0
176,Paper,Paper,9345.0,USD,BITSTAMP,176.0,,,1.0,373.8,2.0,1.0,-8545.0,BOT,BTC,USD,20160326 01:29:32 EST,,800.0,-1297459.175,-3328700.0,373.8,342720.0,-8545.0
177,Paper,Paper,9362.5,USD,BITSTAMP,177.0,,,1.0,374.5,2.0,-1.0,-2362.5,SLD,BTC,USD,20160326 01:36:10 EST,,7000.0,-1299821.675,-3328700.0,374.5,349720.0,-2362.5
178,Paper,Paper,9350.75,USD,BITSTAMP,178.0,,,1.0,374.03,2.0,1.0,-4650.75,BOT,BTC,USD,20160326 01:49:15 EST,,4700.0,-1304472.425,-3328700.0,374.03,354420.0,-4650.75
179,Paper,Paper,9350.75,USD,BITSTAMP,179.0,,,1.0,374.03,2.0,-1.0,-9350.75,SLD,BTC,USD,20160326 01:52:30 EST,,0.0,-1313823.175,-3328700.0,374.03,354420.0,-9350.75
180,Paper,Paper,9338.425,USD,BITSTAMP,180.0,,,1.0,373.537,2.0,1.0,-4408.425,BOT,BTC,USD,20160326 02:13:35 EST,,4930.0,-1318231.6,-3328700.0,373.537,359350.0,-4408.425
181,Paper,Paper,9358.475,USD,BITSTAMP,181.0,,,1.0,374.339,2.0,-1.0,-1338.475,SLD,BTC,USD,20160326 02:17:25 EST,,8020.0,-1319570.075,-3328700.0,374.339,367370.0,-1338.475
182,Paper,Paper,9339.525,USD,BITSTAMP,182.0,,,1.0,373.581,2.0,1.0,-1759.525,BOT,BTC,USD,20160326 02:24:30 EST,,7580.0,-1321329.6,-3328700.0,373.581,374950.0,-1759.525
183,Paper,Paper,9339.775,USD,BITSTAMP,183.0,,,1.0,373.591,2.0,-1.0,-9239.775,SLD,BTC,USD,20160326 02:28:10 EST,,100.0,-1330569.375,-3328700.0,373.591,375050.0,-9239.775
184,Paper,Paper,9370.0,USD,BITSTAMP,184.0,,,1.0,374.8,2.0,1.0,-21460.0,BOT,BTC,USD,20160326 03:34:53 EST,,-12090.0,-1352029.375,-3328700.0,374.8,362960.0,-21460.0
185,Paper,Paper,9372.725,USD,BITSTAMP,185.0,,,1.0,374.909,2.0,-1.0,-8282.725,SLD,BTC,USD,20160326 03:42:02 EST,,1090.0,-1360312.1,-3328700.0,374.909,364050.0,-8282.725
186,Paper,Paper,9370.0,USD,BITSTAMP,186.0,,,1.0,374.8,2.0,1.0,-8280.0,BOT,BTC,USD,20160326 03:45:33 EST,,1090.0,-1368592.1,-3328700.0,374.8,365140.0,-8280.0
187,Paper,Paper,9372.75,USD,BITSTAMP,187.0,,,1.0,374.91,2.0,-1.0,-8272.75,SLD,BTC,USD,20160326 03:48:59 EST,,1100.0,-1376864.85,-3328700.0,374.91,366240.0,-8272.75
188,Paper,Paper,9370.0,USD,BITSTAMP,188.0,,,1.0,374.8,2.0,1.0,-8270.0,BOT,BTC,USD,20160326 04:03:45 EST,,1100.0,-1385134.85,-3328700.0,374.8,367340.0,-8270.0
189,Paper,Paper,9370.0,USD,BITSTAMP,189.0,,,1.0,374.8,2.0,-1.0,-9370.0,SLD,BTC,USD,20160326 04:07:25 EST,,0.0,-1394504.85,-3328700.0,374.8,367340.0,-9370.0
190,Paper,Paper,9370.0,USD,BITSTAMP,190.0,,,1.0,374.8,2.0,1.0,-9370.0,BOT,BTC,USD,20160326 04:22:13 EST,,0.0,-1403874.85,-3328700.0,374.8,367340.0,-9370.0
191,Paper,Paper,9374.75,USD,BITSTAMP,191.0,,,1.0,374.99,2.0,-1.0,-7474.75,SLD,BTC,USD,20160326 04:26:02 EST,,1900.0,-1411349.6,-3328700.0,374.99,369240.0,-7474.75
192,Paper,Paper,9384.5,USD,BITSTAMP,192.0,,,1.0,375.38,2.0,1.0,-13284.5,BOT,BTC,USD,20160326 04:30:14 EST,,-3900.0,-1424634.1,-3328700.0,375.38,365340.0,-13284.5
193,Paper,Paper,9367.5,USD,BITSTAMP,193.0,,,1.0,374.7,2.0,-1.0,-16167.5,SLD,BTC,USD,20160326 04:39:02 EST,,-6800.0,-1440801.6,-3328700.0,374.7,358540.0,-16167.5
194,Paper,Paper,9362.3,USD,BITSTAMP,194.0,,,1.0,374.492,2.0,1.0,-7282.3,BOT,BTC,USD,20160326 04:43:02 EST,,2080.0,-1448083.9,-3328700.0,374.492,360620.0,-7282.3
195,Paper,Paper,9352.8,USD,BITSTAMP,195.0,,,1.0,374.112,2.0,-1.0,-13152.8,SLD,BTC,USD,20160326 04:47:32 EST,,-3800.0,-1461236.7,-3328700.0,374.112,356820.0,-13152.8
196,Paper,Paper,9350.0,USD,BITSTAMP,196.0,,,1.0,374.0,2.0,1.0,-8230.0,BOT,BTC,USD,20160326 05:16:36 EST,,1120.0,-1469466.7,-3328700.0,374.0,357940.0,-8230.0
197,Paper,Paper,9352.775,USD,BITSTAMP,197.0,,,1.0,374.111,2.0,-1.0,-8242.775,SLD,BTC,USD,20160326 05:21:10 EST,,1110.0,-1477709.475,-3328700.0,374.111,359050.0,-8242.775
198,Paper,Paper,9350.0,USD,BITSTAMP,198.0,,,1.0,374.0,2.0,1.0,-8240.0,BOT,BTC,USD,20160326 05:43:24 EST,,1110.0,-1485949.475,-3328700.0,374.0,360160.0,-8240.0
199,Paper,Paper,9353.75,USD,BITSTAMP,199.0,,,1.0,374.15,2.0,-1.0,-7853.75,SLD,BTC,USD,20160326 05:46:46 EST,,1500.0,-1493803.225,-3328700.0,374.15,361660.0,-7853.75
200,Paper,Paper,9350.0,USD,BITSTAMP,200.0,,,1.0,374.0,2.0,1.0,-7850.0,BOT,BTC,USD,20160326 06:04:16 EST,,1500.0,-1501653.225,-3328700.0,374.0,363160.0,-7850.0
201,Paper,Paper,9362.25,USD,BITSTAMP,201.0,,,1.0,374.49,2.0,-1.0,-4462.25,SLD,BTC,USD,20160326 06:12:55 EST,,4900.0,-1506115.475,-3328700.0,374.49,368060.0,-4462.25
202,Paper,Paper,9350.0,USD,BITSTAMP,202.0,,,1.0,374.0,2.0,1.0,-4450.0,BOT,BTC,USD,20160326 06:43:14 EST,,4900.0,-1510565.475,-3328700.0,374.0,372960.0,-4450.0
203,Paper,Paper,9366.5,USD,BITSTAMP,203.0,,,1.0,374.66,2.0,-1.0,-2766.5,SLD,BTC,USD,20160326 06:47:10 EST,,6600.0,-1513331.975,-3328700.0,374.66,379560.0,-2766.5
204,Paper,Paper,9334.925,USD,BITSTAMP,204.0,,,1.0,373.397,2.0,1.0,3295.075,BOT,BTC,USD,20160326 07:39:19 EST,,12630.0,-1510036.9,-3328700.0,373.397,392190.0,3295.075
205,Paper,Paper,9347.0,USD,BITSTAMP,205.0,,,1.0,373.88,2.0,-1.0,-4517.0,SLD,BTC,USD,20160326 07:43:22 EST,,4830.0,-1514553.9,-3328700.0,373.88,397020.0,-4517.0
206,Paper,Paper,9345.95,USD,BITSTAMP,206.0,,,1.0,373.838,2.0,1.0,-8925.95,BOT,BTC,USD,20160326 08:10:46 EST,,420.0,-1523479.85,-3328700.0,373.838,397440.0,-8925.95
207,Paper,Paper,9345.7,USD,BITSTAMP,207.0,,,1.0,373.828,2.0,-1.0,-9445.7,SLD,BTC,USD,20160326 08:15:18 EST,,-100.0,-1532925.55,-3328700.0,373.828,397340.0,-9445.7
208,Paper,Paper,9342.5,USD,BITSTAMP,208.0,,,1.0,373.7,2.0,1.0,-8062.5,BOT,BTC,USD,20160326 08:48:28 EST,,1280.0,-1540988.05,-3328700.0,373.7,398620.0,-8062.5
209,Paper,Paper,9346.25,USD,BITSTAMP,209.0,,,1.0,373.85,2.0,-1.0,-7846.25,SLD,BTC,USD,20160326 08:52:58 EST,,1500.0,-1548834.3,-3328700.0,373.85,400120.0,-7846.25
210,Paper,Paper,9345.175,USD,BITSTAMP,210.0,,,1.0,373.807,2.0,1.0,-8915.175,BOT,BTC,USD,20160326 09:51:58 EST,,430.0,-1557749.475,-3328700.0,373.807,400550.0,-8915.175
211,Paper,Paper,9351.05,USD,BITSTAMP,211.0,,,1.0,374.042,2.0,-1.0,-7001.05,SLD,BTC,USD,20160326 10:01:08 EST,,2350.0,-1564750.525,-3328700.0,374.042,402900.0,-7001.05
212,Paper,Paper,9328.775,USD,BITSTAMP,212.0,,,1.0,373.151,2.0,1.0,-418.775,BOT,BTC,USD,20160326 10:55:21 EST,,8910.0,-1565169.3,-3328700.0,373.151,411810.0,-418.775
213,Paper,Paper,9337.5,USD,BITSTAMP,213.0,,,1.0,373.5,2.0,-1.0,-5847.5,SLD,BTC,USD,20160326 10:59:30 EST,,3490.0,-1571016.8,-3328700.0,373.5,415300.0,-5847.5
214,Paper,Paper,9329.9,USD,BITSTAMP,214.0,,,1.0,373.196,2.0,1.0,-6289.9,BOT,BTC,USD,20160326 11:07:56 EST,,3040.0,-1577306.7,-3328700.0,373.196,418340.0,-6289.9
215,Paper,Paper,9340.975,USD,BITSTAMP,215.0,,,1.0,373.639,2.0,-1.0,-4910.975,SLD,BTC,USD,20160326 11:11:55 EST,,4430.0,-1582217.675,-3328700.0,373.639,422770.0,-4910.975
216,Paper,Paper,9325.5,USD,BITSTAMP,216.0,,,1.0,373.02,2.0,1.0,-3135.5,BOT,BTC,USD,20160326 11:30:15 EST,,6190.0,-1585353.175,-3328700.0,373.02,428960.0,-3135.5
217,Paper,Paper,9340.55,USD,BITSTAMP,217.0,,,1.0,373.622,2.0,-1.0,-3320.55,SLD,BTC,USD,20160326 11:35:06 EST,,6020.0,-1588673.725,-3328700.0,373.622,434980.0,-3320.55
218,Paper,Paper,9338.225,USD,BITSTAMP,218.0,,,1.0,373.529,2.0,1.0,-8408.225,BOT,BTC,USD,20160326 12:46:33 EST,,930.0,-1597081.95,-3328700.0,373.529,435910.0,-8408.225
219,Paper,Paper,9349.25,USD,BITSTAMP,219.0,,,1.0,373.97,2.0,-1.0,-4939.25,SLD,BTC,USD,20160326 12:51:26 EST,,4410.0,-1602021.2,-3328700.0,373.97,440320.0,-4939.25
220,Paper,Paper,9327.75,USD,BITSTAMP,220.0,,,1.0,373.11,2.0,1.0,-727.75,BOT,BTC,USD,20160326 13:01:15 EST,,8600.0,-1602748.95,-3328700.0,373.11,448920.0,-727.75
221,Paper,Paper,9342.0,USD,BITSTAMP,221.0,,,1.0,373.68,2.0,-1.0,-3642.0,SLD,BTC,USD,20160326 13:06:02 EST,,5700.0,-1606390.95,-3328700.0,373.68,454620.0,-3642.0
222,Paper,Paper,9350.0,USD,BITSTAMP,222.0,,,1.0,374.0,2.0,1.0,-12550.0,BOT,BTC,USD,20160326 16:48:27 EST,,-3200.0,-1618940.95,-3328700.0,374.0,451420.0,-12550.0
223,Paper,Paper,9357.975,USD,BITSTAMP,223.0,,,1.0,374.319,2.0,-1.0,-6167.975,SLD,BTC,USD,20160326 16:53:37 EST,,3190.0,-1625108.925,-3328700.0,374.319,454610.0,-6167.975
224,Paper,Paper,9348.75,USD,BITSTAMP,224.0,,,1.0,373.95,2.0,1.0,-5658.75,BOT,BTC,USD,20160326 17:31:00 EST,,3690.0,-1630767.675,-3328700.0,373.95,458300.0,-5658.75
225,Paper,Paper,9343.5,USD,BITSTAMP,225.0,,,1.0,373.74,2.0,-1.0,-11443.5,SLD,BTC,USD,20160326 17:42:03 EST,,-2100.0,-1642211.175,-3328700.0,373.74,456200.0,-11443.5
226,Paper,Paper,9344.5,USD,BITSTAMP,226.0,,,1.0,373.78,2.0,1.0,-9744.5,BOT,BTC,USD,20160326 17:53:09 EST,,-400.0,-1651955.675,-3328700.0,373.78,455800.0,-9744.5
227,Paper,Paper,9339.35,USD,BITSTAMP,227.0,,,1.0,373.574,2.0,-1.0,-11399.35,SLD,BTC,USD,20160326 17:58:34 EST,,-2060.0,-1663355.025,-3328700.0,373.574,453740.0,-11399.35
228,Paper,Paper,9347.25,USD,BITSTAMP,228.0,,,1.0,373.89,2.0,1.0,-12507.25,BOT,BTC,USD,20160326 18:42:46 EST,,-3160.0,-1675862.275,-3328700.0,373.89,450580.0,-12507.25
229,Paper,Paper,9352.5,USD,BITSTAMP,229.0,,,1.0,374.1,2.0,-1.0,-7252.5,SLD,BTC,USD,20160326 18:48:03 EST,,2100.0,-1683114.775,-3328700.0,374.1,452680.0,-7252.5
230,Paper,Paper,9347.0,USD,BITSTAMP,230.0,,,1.0,373.88,2.0,1.0,-7147.0,BOT,BTC,USD,20160326 20:11:35 EST,,2200.0,-1690261.775,-3328700.0,373.88,454880.0,-7147.0
231,Paper,Paper,9346.65,USD,BITSTAMP,231.0,,,1.0,373.866,2.0,-1.0,-9486.65,SLD,BTC,USD,20160326 20:39:10 EST,,-140.0,-1699748.425,-3328700.0,373.866,454740.0,-9486.65
232,Paper,Paper,9339.35,USD,BITSTAMP,232.0,,,1.0,373.574,2.0,1.0,-6419.35,BOT,BTC,USD,20160326 21:17:59 EST,,2920.0,-1706167.775,-3328700.0,373.574,457660.0,-6419.35
233,Paper,Paper,9344.75,USD,BITSTAMP,233.0,,,1.0,373.79,2.0,-1.0,-7184.75,SLD,BTC,USD,20160326 21:27:39 EST,,2160.0,-1713352.525,-3328700.0,373.79,459820.0,-7184.75
234,Paper,Paper,9336.5,USD,BITSTAMP,234.0,,,1.0,373.46,2.0,1.0,-6036.5,BOT,BTC,USD,20160326 23:12:07 EST,,3300.0,-1719389.025,-3328700.0,373.46,463120.0,-6036.5
235,Paper,Paper,9336.5,USD,BITSTAMP,235.0,,,1.0,373.46,2.0,-1.0,-9336.5,SLD,BTC,USD,20160327 00:04:25 EST,,0.0,-1728725.525,-3328700.0,373.46,463120.0,-9336.5
236,Paper,Paper,9337.75,USD,BITSTAMP,236.0,,,1.0,373.51,2.0,1.0,-9837.75,BOT,BTC,USD,20160327 02:34:54 EST,,-500.0,-1738563.275,-3328700.0,373.51,462620.0,-9837.75
237,Paper,Paper,9337.75,USD,BITSTAMP,237.0,,,1.0,373.51,2.0,-1.0,-9337.75,SLD,BTC,USD,20160327 02:40:11 EST,,0.0,-1747901.025,-3328700.0,373.51,462620.0,-9337.75
238,Paper,Paper,9336.25,USD,BITSTAMP,238.0,,,1.0,373.45,2.0,1.0,-8736.25,BOT,BTC,USD,20160327 03:22:25 EST,,600.0,-1756637.275,-3328700.0,373.45,463220.0,-8736.25
239,Paper,Paper,9342.0,USD,BITSTAMP,239.0,,,1.0,373.68,2.0,-1.0,-7042.0,SLD,BTC,USD,20160327 03:34:17 EST,,2300.0,-1763679.275,-3328700.0,373.68,465520.0,-7042.0
240,Paper,Paper,9338.75,USD,BITSTAMP,240.0,,,1.0,373.55,2.0,1.0,-8038.75,BOT,BTC,USD,20160327 04:46:44 EST,,1300.0,-1771718.025,-3328700.0,373.55,466820.0,-8038.75
241,Paper,Paper,9348.25,USD,BITSTAMP,241.0,,,1.0,373.93,2.0,-1.0,-5548.25,SLD,BTC,USD,20160327 05:09:34 EST,,3800.0,-1777266.275,-3328700.0,373.93,470620.0,-5548.25
242,Paper,Paper,9357.5,USD,BITSTAMP,242.0,,,1.0,374.3,2.0,1.0,-13057.5,BOT,BTC,USD,20160327 06:11:57 EST,,-3700.0,-1790323.775,-3328700.0,374.3,466920.0,-13057.5
243,Paper,Paper,9371.75,USD,BITSTAMP,243.0,,,1.0,374.87,2.0,-1.0,-3671.75,SLD,BTC,USD,20160327 06:29:49 EST,,5700.0,-1793995.525,-3328700.0,374.87,472620.0,-3671.75
244,Paper,Paper,9346.0,USD,BITSTAMP,244.0,,,1.0,373.84,2.0,1.0,954.0,BOT,BTC,USD,20160327 07:22:29 EST,,10300.0,-1793041.525,-3328700.0,373.84,482920.0,954.0
245,Paper,Paper,9362.225,USD,BITSTAMP,245.0,,,1.0,374.489,2.0,-1.0,-2872.225,SLD,BTC,USD,20160327 08:16:26 EST,,6490.0,-1795913.75,-3328700.0,374.489,489410.0,-2872.225
246,Paper,Paper,9362.225,USD,BITSTAMP,246.0,,,1.0,374.489,2.0,1.0,-9362.225,BOT,BTC,USD,20160327 08:29:08 EST,,5.68434188608e-10,-1805275.975,-3328700.0,374.489,489410.0,-9362.225
247,Paper,Paper,9361.35,USD,BITSTAMP,247.0,,,1.0,374.454,2.0,-1.0,-9711.35,SLD,BTC,USD,20160327 09:06:14 EST,,-350.0,-1814987.325,-3328700.0,374.454,489060.0,-9711.35
248,Paper,Paper,9360.25,USD,BITSTAMP,248.0,,,1.0,374.41,2.0,1.0,-8920.25,BOT,BTC,USD,20160327 10:44:07 EST,,440.0,-1823907.575,-3328700.0,374.41,489500.0,-8920.25
249,Paper,Paper,9368.25,USD,BITSTAMP,249.0,,,1.0,374.73,2.0,-1.0,-6168.25,SLD,BTC,USD,20160327 10:47:14 EST,,3200.0,-1830075.825,-3328700.0,374.73,492700.0,-6168.25
250,Paper,Paper,9536.875,USD,BITSTAMP,250.0,,,1.0,381.475,2.0,1.0,-76986.875,BOT,BTC,USD,20160327 12:03:54 EST,,-67450.0,-1907062.7,-3328700.0,381.475,425250.0,-76986.875
251,Paper,Paper,9544.325,USD,BITSTAMP,251.0,,,1.0,381.773,2.0,-1.0,-6564.325,SLD,BTC,USD,20160327 12:07:11 EST,,2980.0,-1913627.025,-3328700.0,381.773,428230.0,-6564.325
252,Paper,Paper,9552.5,USD,BITSTAMP,252.0,,,1.0,382.1,2.0,1.0,-12822.5,BOT,BTC,USD,20160327 12:16:35 EST,,-3270.0,-1926449.525,-3328700.0,382.1,424960.0,-12822.5
253,Paper,Paper,9568.425,USD,BITSTAMP,253.0,,,1.0,382.737,2.0,-1.0,-3198.425,SLD,BTC,USD,20160327 12:19:41 EST,,6370.0,-1929647.95,-3328700.0,382.737,431330.0,-3198.425
254,Paper,Paper,9589.85,USD,BITSTAMP,254.0,,,1.0,383.594,2.0,1.0,-18159.85,BOT,BTC,USD,20160327 12:34:36 EST,,-8570.0,-1947807.8,-3328700.0,383.594,422760.0,-18159.85
255,Paper,Paper,9625.0,USD,BITSTAMP,255.0,,,1.0,385.0,2.0,-1.0,4435.0,SLD,BTC,USD,20160327 12:37:35 EST,,14060.0,-1943372.8,-3328700.0,385.0,436820.0,4435.0
256,Paper,Paper,9600.075,USD,BITSTAMP,256.0,,,1.0,384.003,2.0,1.0,369.925,BOT,BTC,USD,20160327 12:52:41 EST,,9970.0,-1943002.875,-3328700.0,384.003,446790.0,369.925
257,Paper,Paper,9619.425,USD,BITSTAMP,257.0,,,1.0,384.777,2.0,-1.0,-1879.425,SLD,BTC,USD,20160327 12:55:41 EST,,7740.0,-1944882.3,-3328700.0,384.777,454530.0,-1879.425
258,Paper,Paper,9599.25,USD,BITSTAMP,258.0,,,1.0,383.97,2.0,1.0,-1529.25,BOT,BTC,USD,20160327 14:07:11 EST,,8070.0,-1946411.55,-3328700.0,383.97,462600.0,-1529.25
259,Paper,Paper,9600.0,USD,BITSTAMP,259.0,,,1.0,384.0,2.0,-1.0,-9300.0,SLD,BTC,USD,20160327 14:10:19 EST,,300.0,-1955711.55,-3328700.0,384.0,462900.0,-9300.0
260,Paper,Paper,9606.5,USD,BITSTAMP,260.0,,,1.0,384.26,2.0,1.0,-12206.5,BOT,BTC,USD,20160327 14:45:37 EST,,-2600.0,-1967918.05,-3328700.0,384.26,460300.0,-12206.5
261,Paper,Paper,9594.25,USD,BITSTAMP,261.0,,,1.0,383.77,2.0,-1.0,-14494.25,SLD,BTC,USD,20160327 14:48:48 EST,,-4900.0,-1982412.3,-3328700.0,383.77,455400.0,-14494.25
262,Paper,Paper,9587.775,USD,BITSTAMP,262.0,,,1.0,383.511,2.0,1.0,-6997.775,BOT,BTC,USD,20160327 14:59:55 EST,,2590.0,-1989410.075,-3328700.0,383.511,457990.0,-6997.775
263,Paper,Paper,9613.975,USD,BITSTAMP,263.0,,,1.0,384.559,2.0,-1.0,866.025000001,SLD,BTC,USD,20160327 15:02:35 EST,,10480.0,-1988544.05,-3328700.0,384.559,468470.0,866.025000001
264,Paper,Paper,9586.0,USD,BITSTAMP,264.0,,,1.0,383.44,2.0,1.0,1604.0,BOT,BTC,USD,20160327 15:05:23 EST,,11190.0,-1986940.05,-3328700.0,383.44,479660.0,1604.0
265,Paper,Paper,9599.975,USD,BITSTAMP,265.0,,,1.0,383.999,2.0,-1.0,-4009.975,SLD,BTC,USD,20160327 15:11:04 EST,,5590.0,-1990950.025,-3328700.0,383.999,485250.0,-4009.975
266,Paper,Paper,9576.5,USD,BITSTAMP,266.0,,,1.0,383.06,2.0,1.0,-186.5,BOT,BTC,USD,20160327 15:33:57 EST,,9390.0,-1991136.525,-3328700.0,383.06,494640.0,-186.5
267,Paper,Paper,9577.5,USD,BITSTAMP,267.0,,,1.0,383.1,2.0,-1.0,-9177.5,SLD,BTC,USD,20160327 15:36:52 EST,,400.0,-2000314.025,-3328700.0,383.1,495040.0,-9177.5
268,Paper,Paper,9578.25,USD,BITSTAMP,268.0,,,1.0,383.13,2.0,1.0,-9878.25,BOT,BTC,USD,20160327 16:30:49 EST,,-300.0,-2010192.275,-3328700.0,383.13,494740.0,-9878.25
269,Paper,Paper,9588.0,USD,BITSTAMP,269.0,,,1.0,383.52,2.0,-1.0,-5688.0,SLD,BTC,USD,20160327 16:33:51 EST,,3900.0,-2015880.275,-3328700.0,383.52,498640.0,-5688.0
270,Paper,Paper,9573.9,USD,BITSTAMP,270.0,,,1.0,382.956,2.0,1.0,-3933.9,BOT,BTC,USD,20160327 16:50:45 EST,,5640.0,-2019814.175,-3328700.0,382.956,504280.0,-3933.9
271,Paper,Paper,9534.5,USD,BITSTAMP,271.0,,,1.0,381.38,2.0,-1.0,-25294.5,SLD,BTC,USD,20160327 16:57:27 EST,,-15760.0,-2045108.675,-3328700.0,381.38,488520.0,-25294.5
272,Paper,Paper,9574.75,USD,BITSTAMP,272.0,,,1.0,382.99,2.0,1.0,-25674.75,BOT,BTC,USD,20160327 17:10:44 EST,,-16100.0,-2070783.425,-3328700.0,382.99,472420.0,-25674.75
273,Paper,Paper,9557.55,USD,BITSTAMP,273.0,,,1.0,382.302,2.0,-1.0,-16437.55,SLD,BTC,USD,20160327 17:14:11 EST,,-6880.0,-2087220.975,-3328700.0,382.302,465540.0,-16437.55
274,Paper,Paper,9552.025,USD,BITSTAMP,274.0,,,1.0,382.081,2.0,1.0,-7342.025,BOT,BTC,USD,20160327 17:24:20 EST,,2210.0,-2094563.0,-3328700.0,382.081,467750.0,-7342.025
275,Paper,Paper,9557.85,USD,BITSTAMP,275.0,,,1.0,382.314,2.0,-1.0,-7227.85,SLD,BTC,USD,20160327 17:27:41 EST,,2330.0,-2101790.85,-3328700.0,382.314,470080.0,-7227.85
276,Paper,Paper,9535.25,USD,BITSTAMP,276.0,,,1.0,381.41,2.0,1.0,-495.25,BOT,BTC,USD,20160327 17:41:59 EST,,9040.0,-2102286.1,-3328700.0,381.41,479120.0,-495.25
277,Paper,Paper,9546.025,USD,BITSTAMP,277.0,,,1.0,381.841,2.0,-1.0,-5236.025,SLD,BTC,USD,20160327 17:45:32 EST,,4310.0,-2107522.125,-3328700.0,381.841,483430.0,-5236.025
278,Paper,Paper,9574.5,USD,BITSTAMP,278.0,,,1.0,382.98,2.0,1.0,-20964.5,BOT,BTC,USD,20160327 18:17:17 EST,,-11390.0,-2128486.625,-3328700.0,382.98,472040.0,-20964.5
279,Paper,Paper,9572.5,USD,BITSTAMP,279.0,,,1.0,382.9,2.0,-1.0,-10372.5,SLD,BTC,USD,20160327 18:20:46 EST,,-800.0,-2138859.125,-3328700.0,382.9,471240.0,-10372.5
280,Paper,Paper,9532.375,USD,BITSTAMP,280.0,,,1.0,381.295,2.0,1.0,6517.625,BOT,BTC,USD,20160327 19:22:42 EST,,16050.0,-2132341.5,-3328700.0,381.295,487290.0,6517.625
281,Paper,Paper,9552.25,USD,BITSTAMP,281.0,,,1.0,382.09,2.0,-1.0,-1602.25,SLD,BTC,USD,20160327 19:24:31 EST,,7950.0,-2133943.75,-3328700.0,382.09,495240.0,-1602.25
282,Paper,Paper,9538.475,USD,BITSTAMP,282.0,,,1.0,381.539,2.0,1.0,-4028.475,BOT,BTC,USD,20160327 19:26:22 EST,,5510.0,-2137972.225,-3328700.0,381.539,500750.0,-4028.475
283,Paper,Paper,9552.175,USD,BITSTAMP,283.0,,,1.0,382.087,2.0,-1.0,-4072.175,SLD,BTC,USD,20160327 19:28:13 EST,,5480.0,-2142044.4,-3328700.0,382.087,506230.0,-4072.175
284,Paper,Paper,9538.5,USD,BITSTAMP,284.0,,,1.0,381.54,2.0,1.0,-4068.5,BOT,BTC,USD,20160327 19:58:17 EST,,5470.0,-2146112.9,-3328700.0,381.54,511700.0,-4068.5
285,Paper,Paper,9528.95,USD,BITSTAMP,285.0,,,1.0,381.158,2.0,-1.0,-13348.95,SLD,BTC,USD,20160327 20:03:54 EST,,-3820.0,-2159461.85,-3328700.0,381.158,507880.0,-13348.95
286,Paper,Paper,9527.9,USD,BITSTAMP,286.0,,,1.0,381.116,2.0,1.0,-9107.9,BOT,BTC,USD,20160327 20:15:16 EST,,420.0,-2168569.75,-3328700.0,381.116,508300.0,-9107.9
287,Paper,Paper,9549.95,USD,BITSTAMP,287.0,,,1.0,381.998,2.0,-1.0,-729.95,SLD,BTC,USD,20160327 20:17:19 EST,,8820.0,-2169299.7,-3328700.0,381.998,517120.0,-729.95
288,Paper,Paper,9549.5,USD,BITSTAMP,288.0,,,1.0,381.98,2.0,1.0,-9369.5,BOT,BTC,USD,20160327 20:21:19 EST,,180.0,-2178669.2,-3328700.0,381.98,517300.0,-9369.5
289,Paper,Paper,9538.0,USD,BITSTAMP,289.0,,,1.0,381.52,2.0,-1.0,-14138.0,SLD,BTC,USD,20160327 20:24:54 EST,,-4600.0,-2192807.2,-3328700.0,381.52,512700.0,-14138.0
290,Paper,Paper,9523.55,USD,BITSTAMP,290.0,,,1.0,380.942,2.0,1.0,-3743.55,BOT,BTC,USD,20160327 21:12:31 EST,,5780.0,-2196550.75,-3328700.0,380.942,518480.0,-3743.55
291,Paper,Paper,9539.0,USD,BITSTAMP,291.0,,,1.0,381.56,2.0,-1.0,-3359.0,SLD,BTC,USD,20160327 21:14:40 EST,,6180.0,-2199909.75,-3328700.0,381.56,524660.0,-3359.0
292,Paper,Paper,9527.0,USD,BITSTAMP,292.0,,,1.0,381.08,2.0,1.0,-4727.0,BOT,BTC,USD,20160327 21:22:08 EST,,4800.0,-2204636.75,-3328700.0,381.08,529460.0,-4727.0
293,Paper,Paper,9526.0,USD,BITSTAMP,293.0,,,1.0,381.04,2.0,-1.0,-9926.0,SLD,BTC,USD,20160327 21:24:00 EST,,-400.0,-2214562.75,-3328700.0,381.04,529060.0,-9926.0
294,Paper,Paper,9523.35,USD,BITSTAMP,294.0,,,1.0,380.934,2.0,1.0,-8463.35,BOT,BTC,USD,20160327 21:51:05 EST,,1060.0,-2223026.1,-3328700.0,380.934,530120.0,-8463.35
295,Paper,Paper,9524.425,USD,BITSTAMP,295.0,,,1.0,380.977,2.0,-1.0,-9094.425,SLD,BTC,USD,20160327 21:52:55 EST,,429.999999999,-2232120.525,-3328700.0,380.977,530550.0,-9094.425
296,Paper,Paper,9523.6,USD,BITSTAMP,296.0,,,1.0,380.944,2.0,1.0,-9193.6,BOT,BTC,USD,20160327 21:58:35 EST,,330.0,-2241314.125,-3328700.0,380.944,530880.0,-9193.6
297,Paper,Paper,9524.425,USD,BITSTAMP,297.0,,,1.0,380.977,2.0,-1.0,-9194.425,SLD,BTC,USD,20160327 22:00:26 EST,,330.0,-2250508.55,-3328700.0,380.977,531210.0,-9194.425
298,Paper,Paper,9514.275,USD,BITSTAMP,298.0,,,1.0,380.571,2.0,1.0,-5454.275,BOT,BTC,USD,20160327 22:54:01 EST,,4060.0,-2255962.825,-3328700.0,380.571,535270.0,-5454.275
299,Paper,Paper,9514.275,USD,BITSTAMP,299.0,,,1.0,380.571,2.0,-1.0,-9514.275,SLD,BTC,USD,20160327 22:57:50 EST,,5.68434188608e-10,-2265477.1,-3328700.0,380.571,535270.0,-9514.275
300,Paper,Paper,9518.625,USD,BITSTAMP,300.0,,,1.0,380.745,2.0,1.0,-11258.625,BOT,BTC,USD,20160327 23:30:09 EST,,-1740.0,-2276735.725,-3328700.0,380.745,533530.0,-11258.625
301,Paper,Paper,9529.2,USD,BITSTAMP,301.0,,,1.0,381.168,2.0,-1.0,-5299.2,SLD,BTC,USD,20160327 23:33:44 EST,,4230.0,-2282034.925,-3328700.0,381.168,537760.0,-5299.2
302,Paper,Paper,9518.625,USD,BITSTAMP,302.0,,,1.0,380.745,2.0,1.0,-5288.625,BOT,BTC,USD,20160327 23:35:50 EST,,4230.0,-2287323.55,-3328700.0,380.745,541990.0,-5288.625
303,Paper,Paper,9514.075,USD,BITSTAMP,303.0,,,1.0,380.563,2.0,-1.0,-11334.075,SLD,BTC,USD,20160327 23:39:38 EST,,-1820.0,-2298657.625,-3328700.0,380.563,540170.0,-11334.075
304,Paper,Paper,9521.25,USD,BITSTAMP,304.0,,,1.0,380.85,2.0,1.0,-12391.25,BOT,BTC,USD,20160327 23:59:06 EST,,-2870.0,-2311048.875,-3328700.0,380.85,537300.0,-12391.25
305,Paper,Paper,9522.25,USD,BITSTAMP,305.0,,,1.0,380.89,2.0,-1.0,-9122.25,SLD,BTC,USD,20160328 00:01:00 EST,,400.0,-2320171.125,-3328700.0,380.89,537700.0,-9122.25
306,Paper,Paper,9522.5,USD,BITSTAMP,306.0,,,1.0,380.9,2.0,1.0,-9622.5,BOT,BTC,USD,20160328 00:02:59 EST,,-99.9999999999,-2329793.625,-3328700.0,380.9,537600.0,-9622.5
307,Paper,Paper,9522.75,USD,BITSTAMP,307.0,,,1.0,380.91,2.0,-1.0,-9422.75,SLD,BTC,USD,20160328 00:05:03 EST,,100.0,-2339216.375,-3328700.0,380.91,537700.0,-9422.75
308,Paper,Paper,9531.775,USD,BITSTAMP,308.0,,,1.0,381.271,2.0,1.0,-13141.775,BOT,BTC,USD,20160328 00:13:08 EST,,-3610.0,-2352358.15,-3328700.0,381.271,534090.0,-13141.775
309,Paper,Paper,9521.75,USD,BITSTAMP,309.0,,,1.0,380.87,2.0,-1.0,-13531.75,SLD,BTC,USD,20160328 00:14:56 EST,,-4010.0,-2365889.9,-3328700.0,380.87,530080.0,-13531.75
310,Paper,Paper,9537.25,USD,BITSTAMP,310.0,,,1.0,381.49,2.0,1.0,-15737.25,BOT,BTC,USD,20160328 00:49:25 EST,,-6200.0,-2381627.15,-3328700.0,381.49,523880.0,-15737.25
311,Paper,Paper,9530.0,USD,BITSTAMP,311.0,,,1.0,381.2,2.0,-1.0,-12430.0,SLD,BTC,USD,20160328 00:51:21 EST,,-2900.0,-2394057.15,-3328700.0,381.2,520980.0,-12430.0
312,Paper,Paper,9514.1,USD,BITSTAMP,312.0,,,1.0,380.564,2.0,1.0,-3154.1,BOT,BTC,USD,20160328 00:55:20 EST,,6360.0,-2397211.25,-3328700.0,380.564,527340.0,-3154.1
313,Paper,Paper,9515.75,USD,BITSTAMP,313.0,,,1.0,380.63,2.0,-1.0,-8855.75,SLD,BTC,USD,20160328 00:57:21 EST,,660.0,-2406067.0,-3328700.0,380.63,528000.0,-8855.75
314,Paper,Paper,9516.25,USD,BITSTAMP,314.0,,,1.0,380.65,2.0,1.0,-9716.25,BOT,BTC,USD,20160328 01:14:59 EST,,-200.0,-2415783.25,-3328700.0,380.65,527800.0,-9716.25
315,Paper,Paper,9519.5,USD,BITSTAMP,315.0,,,1.0,380.78,2.0,-1.0,-8219.5,SLD,BTC,USD,20160328 01:16:51 EST,,1300.0,-2424002.75,-3328700.0,380.78,529100.0,-8219.5
316,Paper,Paper,9552.45,USD,BITSTAMP,316.0,,,1.0,382.098,2.0,1.0,-22732.45,BOT,BTC,USD,20160328 01:41:58 EST,,-13180.0,-2446735.2,-3328700.0,382.098,515920.0,-22732.45
317,Paper,Paper,9543.75,USD,BITSTAMP,317.0,,,1.0,381.75,2.0,-1.0,-13023.75,SLD,BTC,USD,20160328 01:46:00 EST,,-3480.0,-2459758.95,-3328700.0,381.75,512440.0,-13023.75
318,Paper,Paper,9544.025,USD,BITSTAMP,318.0,,,1.0,381.761,2.0,1.0,-9654.025,BOT,BTC,USD,20160328 02:23:08 EST,,-110.0,-2469412.975,-3328700.0,381.761,512330.0,-9654.025
319,Paper,Paper,9563.0,USD,BITSTAMP,319.0,,,1.0,382.52,2.0,-1.0,-1973.0,SLD,BTC,USD,20160328 02:25:14 EST,,7590.0,-2471385.975,-3328700.0,382.52,519920.0,-1973.0
320,Paper,Paper,9539.025,USD,BITSTAMP,320.0,,,1.0,381.561,2.0,1.0,50.975,BOT,BTC,USD,20160328 02:27:07 EST,,9590.0,-2471335.0,-3328700.0,381.561,529510.0,50.975
321,Paper,Paper,9547.5,USD,BITSTAMP,321.0,,,1.0,381.9,2.0,-1.0,-6157.5,SLD,BTC,USD,20160328 02:31:08 EST,,3390.0,-2477492.5,-3328700.0,381.9,532900.0,-6157.5
322,Paper,Paper,9523.15,USD,BITSTAMP,322.0,,,1.0,380.926,2.0,1.0,216.85,BOT,BTC,USD,20160328 02:54:51 EST,,9740.0,-2477275.65,-3328700.0,380.926,542640.0,216.85
323,Paper,Paper,9523.375,USD,BITSTAMP,323.0,,,1.0,380.935,2.0,-1.0,-9433.375,SLD,BTC,USD,20160328 02:56:46 EST,,90.0000000001,-2486709.025,-3328700.0,380.935,542730.0,-9433.375
324,Paper,Paper,9523.125,USD,BITSTAMP,324.0,,,1.0,380.925,2.0,1.0,-9423.125,BOT,BTC,USD,20160328 03:16:45 EST,,99.9999999999,-2496132.15,-3328700.0,380.925,542830.0,-9423.125
325,Paper,Paper,9526.0,USD,BITSTAMP,325.0,,,1.0,381.04,2.0,-1.0,-8376.0,SLD,BTC,USD,20160328 03:18:40 EST,,1150.0,-2504508.15,-3328700.0,381.04,543980.0,-8376.0
326,Paper,Paper,9514.825,USD,BITSTAMP,326.0,,,1.0,380.593,2.0,1.0,-5044.825,BOT,BTC,USD,20160328 03:30:30 EST,,4470.0,-2509552.975,-3328700.0,380.593,548450.0,-5044.825
327,Paper,Paper,9514.825,USD,BITSTAMP,327.0,,,1.0,380.593,2.0,-1.0,-9514.825,SLD,BTC,USD,20160328 03:32:32 EST,,0.0,-2519067.8,-3328700.0,380.593,548450.0,-9514.825
328,Paper,Paper,9520.65,USD,BITSTAMP,328.0,,,1.0,380.826,2.0,1.0,-11850.65,BOT,BTC,USD,20160328 03:50:41 EST,,-2330.0,-2530918.45,-3328700.0,380.826,546120.0,-11850.65
329,Paper,Paper,9520.375,USD,BITSTAMP,329.0,,,1.0,380.815,2.0,-1.0,-9630.375,SLD,BTC,USD,20160328 03:52:42 EST,,-110.0,-2540548.825,-3328700.0,380.815,546010.0,-9630.375
330,Paper,Paper,9520.625,USD,BITSTAMP,330.0,,,1.0,380.825,2.0,1.0,-9620.625,BOT,BTC,USD,20160328 03:54:37 EST,,-99.9999999999,-2550169.45,-3328700.0,380.825,545910.0,-9620.625
331,Paper,Paper,9528.0,USD,BITSTAMP,331.0,,,1.0,381.12,2.0,-1.0,-6578.0,SLD,BTC,USD,20160328 03:56:32 EST,,2950.0,-2556747.45,-3328700.0,381.12,548860.0,-6578.0
332,Paper,Paper,9517.75,USD,BITSTAMP,332.0,,,1.0,380.71,2.0,1.0,-5417.75,BOT,BTC,USD,20160328 03:58:28 EST,,4100.0,-2562165.2,-3328700.0,380.71,552960.0,-5417.75
333,Paper,Paper,9517.5,USD,BITSTAMP,333.0,,,1.0,380.7,2.0,-1.0,-9617.5,SLD,BTC,USD,20160328 04:00:26 EST,,-99.9999999999,-2571782.7,-3328700.0,380.7,552860.0,-9617.5
334,Paper,Paper,9517.5,USD,BITSTAMP,334.0,,,1.0,380.7,2.0,1.0,-9517.5,BOT,BTC,USD,20160328 04:04:23 EST,,0.0,-2581300.2,-3328700.0,380.7,552860.0,-9517.5
335,Paper,Paper,9517.5,USD,BITSTAMP,335.0,,,1.0,380.7,2.0,-1.0,-9517.5,SLD,BTC,USD,20160328 04:06:32 EST,,0.0,-2590817.7,-3328700.0,380.7,552860.0,-9517.5
336,Paper,Paper,9518.8,USD,BITSTAMP,336.0,,,1.0,380.752,2.0,1.0,-10038.8,BOT,BTC,USD,20160328 04:22:41 EST,,-520.0,-2600856.5,-3328700.0,380.752,552340.0,-10038.8
337,Paper,Paper,9530.0,USD,BITSTAMP,337.0,,,1.0,381.2,2.0,-1.0,-5050.0,SLD,BTC,USD,20160328 04:24:35 EST,,4480.0,-2605906.5,-3328700.0,381.2,556820.0,-5050.0
338,Paper,Paper,9514.65,USD,BITSTAMP,338.0,,,1.0,380.586,2.0,1.0,-3374.65,BOT,BTC,USD,20160328 05:11:49 EST,,6140.0,-2609281.15,-3328700.0,380.586,562960.0,-3374.65
339,Paper,Paper,9514.675,USD,BITSTAMP,339.0,,,1.0,380.587,2.0,-1.0,-9504.675,SLD,BTC,USD,20160328 05:14:10 EST,,9.99999999976,-2618785.825,-3328700.0,380.587,562970.0,-9504.675
340,Paper,Paper,9522.4,USD,BITSTAMP,340.0,,,1.0,380.896,2.0,1.0,-12612.4,BOT,BTC,USD,20160328 05:59:47 EST,,-3090.0,-2631398.225,-3328700.0,380.896,559880.0,-12612.4
341,Paper,Paper,9529.125,USD,BITSTAMP,341.0,,,1.0,381.165,2.0,-1.0,-6839.125,SLD,BTC,USD,20160328 06:01:47 EST,,2690.0,-2638237.35,-3328700.0,381.165,562570.0,-6839.125
342,Paper,Paper,9522.4,USD,BITSTAMP,342.0,,,1.0,380.896,2.0,1.0,-6832.4,BOT,BTC,USD,20160328 06:18:05 EST,,2690.0,-2645069.75,-3328700.0,380.896,565260.0,-6832.4
343,Paper,Paper,9522.4,USD,BITSTAMP,343.0,,,1.0,380.896,2.0,-1.0,-9522.4,SLD,BTC,USD,20160328 06:20:19 EST,,5.68434188608e-10,-2654592.15,-3328700.0,380.896,565260.0,-9522.4
344,Paper,Paper,9519.775,USD,BITSTAMP,344.0,,,1.0,380.791,2.0,1.0,-8469.775,BOT,BTC,USD,20160328 06:22:41 EST,,1050.0,-2663061.925,-3328700.0,380.791,566310.0,-8469.775
345,Paper,Paper,9532.45,USD,BITSTAMP,345.0,,,1.0,381.298,2.0,-1.0,-4462.45,SLD,BTC,USD,20160328 06:24:48 EST,,5070.0,-2667524.375,-3328700.0,381.298,571380.0,-4462.45
346,Paper,Paper,9516.6,USD,BITSTAMP,346.0,,,1.0,380.664,2.0,1.0,-3176.6,BOT,BTC,USD,20160328 06:30:57 EST,,6340.0,-2670700.975,-3328700.0,380.664,577720.0,-3176.6
347,Paper,Paper,9519.65,USD,BITSTAMP,347.0,,,1.0,380.786,2.0,-1.0,-8299.65,SLD,BTC,USD,20160328 06:33:03 EST,,1220.0,-2679000.625,-3328700.0,380.786,578940.0,-8299.65
348,Paper,Paper,9515.875,USD,BITSTAMP,348.0,,,1.0,380.635,2.0,1.0,-8005.875,BOT,BTC,USD,20160328 06:49:39 EST,,1510.0,-2687006.5,-3328700.0,380.635,580450.0,-8005.875
349,Paper,Paper,9537.55,USD,BITSTAMP,349.0,,,1.0,381.502,2.0,-1.0,-867.55,SLD,BTC,USD,20160328 06:51:52 EST,,8670.0,-2687874.05,-3328700.0,381.502,589120.0,-867.55
350,Paper,Paper,9530.85,USD,BITSTAMP,350.0,,,1.0,381.234,2.0,1.0,-6850.85,BOT,BTC,USD,20160328 06:53:55 EST,,2680.0,-2694724.9,-3328700.0,381.234,591800.0,-6850.85
351,Paper,Paper,9518.65,USD,BITSTAMP,351.0,,,1.0,380.746,2.0,-1.0,-14398.65,SLD,BTC,USD,20160328 06:55:57 EST,,-4880.0,-2709123.55,-3328700.0,380.746,586920.0,-14398.65
352,Paper,Paper,9527.525,USD,BITSTAMP,352.0,,,1.0,381.101,2.0,1.0,-13077.525,BOT,BTC,USD,20160328 07:08:39 EST,,-3550.0,-2722201.075,-3328700.0,381.101,583370.0,-13077.525
353,Paper,Paper,9538.475,USD,BITSTAMP,353.0,,,1.0,381.539,2.0,-1.0,-5158.475,SLD,BTC,USD,20160328 07:10:59 EST,,4380.0,-2727359.55,-3328700.0,381.539,587750.0,-5158.475
354,Paper,Paper,9532.95,USD,BITSTAMP,354.0,,,1.0,381.318,2.0,1.0,-7322.95,BOT,BTC,USD,20160328 07:17:19 EST,,2210.0,-2734682.5,-3328700.0,381.318,589960.0,-7322.95
355,Paper,Paper,9547.625,USD,BITSTAMP,355.0,,,1.0,381.905,2.0,-1.0,-3677.625,SLD,BTC,USD,20160328 07:19:23 EST,,5870.0,-2738360.125,-3328700.0,381.905,595830.0,-3677.625
356,Paper,Paper,9523.55,USD,BITSTAMP,356.0,,,1.0,380.942,2.0,1.0,106.45,BOT,BTC,USD,20160328 07:52:50 EST,,9630.0,-2738253.675,-3328700.0,380.942,605460.0,106.45
357,Paper,Paper,9532.0,USD,BITSTAMP,357.0,,,1.0,381.28,2.0,-1.0,-6152.0,SLD,BTC,USD,20160328 07:55:00 EST,,3380.0,-2744405.675,-3328700.0,381.28,608840.0,-6152.0
358,Paper,Paper,9516.175,USD,BITSTAMP,358.0,,,1.0,380.647,2.0,1.0,-3186.175,BOT,BTC,USD,20160328 08:08:00 EST,,6330.0,-2747591.85,-3328700.0,380.647,615170.0,-3186.175
359,Paper,Paper,9529.975,USD,BITSTAMP,359.0,,,1.0,381.199,2.0,-1.0,-4009.975,SLD,BTC,USD,20160328 08:09:59 EST,,5520.0,-2751601.825,-3328700.0,381.199,620690.0,-4009.975
360,Paper,Paper,9508.925,USD,BITSTAMP,360.0,,,1.0,380.357,2.0,1.0,-1088.925,BOT,BTC,USD,20160328 08:16:20 EST,,8420.0,-2752690.75,-3328700.0,380.357,629110.0,-1088.925
361,Paper,Paper,9509.0,USD,BITSTAMP,361.0,,,1.0,380.36,2.0,-1.0,-9479.0,SLD,BTC,USD,20160328 08:18:21 EST,,30.0000000004,-2762169.75,-3328700.0,380.36,629140.0,-9479.0
362,Paper,Paper,9481.725,USD,BITSTAMP,362.0,,,1.0,379.269,2.0,1.0,1428.275,BOT,BTC,USD,20160328 08:47:06 EST,,10910.0,-2760741.475,-3328700.0,379.269,640050.0,1428.275
363,Paper,Paper,9466.0,USD,BITSTAMP,363.0,,,1.0,378.64,2.0,-1.0,-15756.0,SLD,BTC,USD,20160328 08:51:34 EST,,-6290.0,-2776497.475,-3328700.0,378.64,633760.0,-15756.0
364,Paper,Paper,9448.05,USD,BITSTAMP,364.0,,,1.0,377.922,2.0,1.0,-2268.05,BOT,BTC,USD,20160328 08:55:52 EST,,7180.0,-2778765.525,-3328700.0,377.922,640940.0,-2268.05
365,Paper,Paper,9448.725,USD,BITSTAMP,365.0,,,1.0,377.949,2.0,-1.0,-9178.725,SLD,BTC,USD,20160328 08:58:06 EST,,270.0,-2787944.25,-3328700.0,377.949,641210.0,-9178.725
366,Paper,Paper,9434.825,USD,BITSTAMP,366.0,,,1.0,377.393,2.0,1.0,-3874.825,BOT,BTC,USD,20160328 09:06:51 EST,,5560.0,-2791819.075,-3328700.0,377.393,646770.0,-3874.825
367,Paper,Paper,9439.8,USD,BITSTAMP,367.0,,,1.0,377.592,2.0,-1.0,-7449.8,SLD,BTC,USD,20160328 09:08:59 EST,,1990.0,-2799268.875,-3328700.0,377.592,648760.0,-7449.8
368,Paper,Paper,9450.0,USD,BITSTAMP,368.0,,,1.0,378.0,2.0,1.0,-13530.0,BOT,BTC,USD,20160328 09:30:43 EST,,-4080.0,-2812798.875,-3328700.0,378.0,644680.0,-13530.0
369,Paper,Paper,9449.975,USD,BITSTAMP,369.0,,,1.0,377.999,2.0,-1.0,-9459.975,SLD,BTC,USD,20160328 09:32:49 EST,,-9.99999999976,-2822258.85,-3328700.0,377.999,644670.0,-9459.975
370,Paper,Paper,9448.5,USD,BITSTAMP,370.0,,,1.0,377.94,2.0,1.0,-8858.5,BOT,BTC,USD,20160328 09:46:19 EST,,590.0,-2831117.35,-3328700.0,377.94,645260.0,-8858.5
371,Paper,Paper,9450.375,USD,BITSTAMP,371.0,,,1.0,378.015,2.0,-1.0,-8700.375,SLD,BTC,USD,20160328 09:48:24 EST,,750.0,-2839817.725,-3328700.0,378.015,646010.0,-8700.375
372,Paper,Paper,9448.75,USD,BITSTAMP,372.0,,,1.0,377.95,2.0,1.0,-8798.75,BOT,BTC,USD,20160328 10:01:29 EST,,650.0,-2848616.475,-3328700.0,377.95,646660.0,-8798.75
373,Paper,Paper,9470.75,USD,BITSTAMP,373.0,,,1.0,378.83,2.0,-1.0,-670.75,SLD,BTC,USD,20160328 10:05:50 EST,,8800.0,-2849287.225,-3328700.0,378.83,655460.0,-670.75
374,Paper,Paper,9466.5,USD,BITSTAMP,374.0,,,1.0,378.66,2.0,1.0,-7766.5,BOT,BTC,USD,20160328 10:10:03 EST,,1700.0,-2857053.725,-3328700.0,378.66,657160.0,-7766.5
375,Paper,Paper,9447.825,USD,BITSTAMP,375.0,,,1.0,377.913,2.0,-1.0,-16917.825,SLD,BTC,USD,20160328 10:12:22 EST,,-7470.0,-2873971.55,-3328700.0,377.913,649690.0,-16917.825
376,Paper,Paper,9442.65,USD,BITSTAMP,376.0,,,1.0,377.706,2.0,1.0,-7372.65,BOT,BTC,USD,20160328 10:29:48 EST,,2070.0,-2881344.2,-3328700.0,377.706,651760.0,-7372.65
377,Paper,Paper,9442.65,USD,BITSTAMP,377.0,,,1.0,377.706,2.0,-1.0,-9442.65,SLD,BTC,USD,20160328 10:32:09 EST,,5.68434188608e-10,-2890786.85,-3328700.0,377.706,651760.0,-9442.65
378,Paper,Paper,9448.35,USD,BITSTAMP,378.0,,,1.0,377.934,2.0,1.0,-11728.35,BOT,BTC,USD,20160328 10:45:50 EST,,-2280.0,-2902515.2,-3328700.0,377.934,649480.0,-11728.35
379,Paper,Paper,9448.5,USD,BITSTAMP,379.0,,,1.0,377.94,2.0,-1.0,-9388.5,SLD,BTC,USD,20160328 10:50:28 EST,,59.9999999997,-2911903.7,-3328700.0,377.94,649540.0,-9388.5
380,Paper,Paper,9457.5,USD,BITSTAMP,380.0,,,1.0,378.3,2.0,1.0,-13057.5,BOT,BTC,USD,20160328 11:08:12 EST,,-3600.0,-2924961.2,-3328700.0,378.3,645940.0,-13057.5
381,Paper,Paper,9457.5,USD,BITSTAMP,381.0,,,1.0,378.3,2.0,-1.0,-9457.5,SLD,BTC,USD,20160328 11:10:34 EST,,0.0,-2934418.7,-3328700.0,378.3,645940.0,-9457.5
382,Paper,Paper,9440.5,USD,BITSTAMP,382.0,,,1.0,377.62,2.0,1.0,-2640.5,BOT,BTC,USD,20160328 11:32:58 EST,,6800.0,-2937059.2,-3328700.0,377.62,652740.0,-2640.5
383,Paper,Paper,9443.25,USD,BITSTAMP,383.0,,,1.0,377.73,2.0,-1.0,-8343.25,SLD,BTC,USD,20160328 11:35:14 EST,,1100.0,-2945402.45,-3328700.0,377.73,653840.0,-8343.25
384,Paper,Paper,9445.25,USD,BITSTAMP,384.0,,,1.0,377.81,2.0,1.0,-10245.25,BOT,BTC,USD,20160328 11:37:24 EST,,-800.0,-2955647.7,-3328700.0,377.81,653040.0,-10245.25
385,Paper,Paper,9448.5,USD,BITSTAMP,385.0,,,1.0,377.94,2.0,-1.0,-8148.5,SLD,BTC,USD,20160328 11:39:50 EST,,1300.0,-2963796.2,-3328700.0,377.94,654340.0,-8148.5
386,Paper,Paper,9433.25,USD,BITSTAMP,386.0,,,1.0,377.33,2.0,1.0,-3333.25,BOT,BTC,USD,20160328 12:07:14 EST,,6100.0,-2967129.45,-3328700.0,377.33,660440.0,-3333.25
387,Paper,Paper,9430.0,USD,BITSTAMP,387.0,,,1.0,377.2,2.0,-1.0,-10730.0,SLD,BTC,USD,20160328 12:09:26 EST,,-1300.0,-2977859.45,-3328700.0,377.2,659140.0,-10730.0
388,Paper,Paper,9425.25,USD,BITSTAMP,388.0,,,1.0,377.01,2.0,1.0,-7525.25,BOT,BTC,USD,20160328 12:27:25 EST,,1900.0,-2985384.7,-3328700.0,377.01,661040.0,-7525.25
389,Paper,Paper,9432.25,USD,BITSTAMP,389.0,,,1.0,377.29,2.0,-1.0,-6632.25,SLD,BTC,USD,20160328 12:29:47 EST,,2800.0,-2992016.95,-3328700.0,377.29,663840.0,-6632.25
390,Paper,Paper,9414.8,USD,BITSTAMP,390.0,,,1.0,376.592,2.0,1.0,-2434.8,BOT,BTC,USD,20160328 12:32:02 EST,,6980.0,-2994451.75,-3328700.0,376.592,670820.0,-2434.8
391,Paper,Paper,9405.425,USD,BITSTAMP,391.0,,,1.0,376.217,2.0,-1.0,-13155.425,SLD,BTC,USD,20160328 12:36:45 EST,,-3750.0,-3007607.175,-3328700.0,376.217,667070.0,-13155.425
392,Paper,Paper,9442.975,USD,BITSTAMP,392.0,,,1.0,377.719,2.0,1.0,-24462.975,BOT,BTC,USD,20160328 13:13:14 EST,,-15020.0,-3032070.15,-3328700.0,377.719,652050.0,-24462.975
393,Paper,Paper,9424.95,USD,BITSTAMP,393.0,,,1.0,376.998,2.0,-1.0,-16634.95,SLD,BTC,USD,20160328 13:15:32 EST,,-7210.0,-3048705.1,-3328700.0,376.998,644840.0,-16634.95
394,Paper,Paper,9438.75,USD,BITSTAMP,394.0,,,1.0,377.55,2.0,1.0,-14958.75,BOT,BTC,USD,20160328 16:16:35 EST,,-5520.0,-3063663.85,-3328700.0,377.55,639320.0,-14958.75
395,Paper,Paper,9438.0,USD,BITSTAMP,395.0,,,1.0,377.52,2.0,-1.0,-9738.0,SLD,BTC,USD,20160328 16:18:59 EST,,-300.0,-3073401.85,-3328700.0,377.52,639020.0,-9738.0
396,Paper,Paper,9417.0,USD,BITSTAMP,396.0,,,1.0,376.68,2.0,1.0,-1017.0,BOT,BTC,USD,20160328 16:31:29 EST,,8400.0,-3074418.85,-3328700.0,376.68,647420.0,-1017.0
397,Paper,Paper,9417.0,USD,BITSTAMP,397.0,,,1.0,376.68,2.0,-1.0,-9417.0,SLD,BTC,USD,20160328 16:33:58 EST,,0.0,-3083835.85,-3328700.0,376.68,647420.0,-9417.0
398,Paper,Paper,9419.25,USD,BITSTAMP,398.0,,,1.0,376.77,2.0,1.0,-10319.25,BOT,BTC,USD,20160328 17:47:12 EST,,-900.0,-3094155.1,-3328700.0,376.77,646520.0,-10319.25
399,Paper,Paper,9419.25,USD,BITSTAMP,399.0,,,1.0,376.77,2.0,-1.0,-9419.25,SLD,BTC,USD,20160328 17:49:41 EST,,0.0,-3103574.35,-3328700.0,376.77,646520.0,-9419.25
400,Paper,Paper,9415.75,USD,BITSTAMP,400.0,,,1.0,376.63,2.0,1.0,-8015.75,BOT,BTC,USD,20160328 18:00:18 EST,,1400.0,-3111590.1,-3328700.0,376.63,647920.0,-8015.75
401,Paper,Paper,9417.0,USD,BITSTAMP,401.0,,,1.0,376.68,2.0,-1.0,-8917.0,SLD,BTC,USD,20160328 18:05:29 EST,,500.0,-3120507.1,-3328700.0,376.68,648420.0,-8917.0
402,Paper,Paper,9448.5,USD,BITSTAMP,402.0,,,1.0,377.94,2.0,1.0,-22048.5,BOT,BTC,USD,20160328 19:11:24 EST,,-12600.0,-3142555.6,-3328700.0,377.94,635820.0,-22048.5
403,Paper,Paper,9445.75,USD,BITSTAMP,403.0,,,1.0,377.83,2.0,-1.0,-10545.75,SLD,BTC,USD,20160328 19:14:14 EST,,-1100.0,-3153101.35,-3328700.0,377.83,634720.0,-10545.75
404,Paper,Paper,9424.25,USD,BITSTAMP,404.0,,,1.0,376.97,2.0,1.0,-824.25,BOT,BTC,USD,20160328 20:36:06 EST,,8600.0,-3153925.6,-3328700.0,376.97,643320.0,-824.25
405,Paper,Paper,9448.0,USD,BITSTAMP,405.0,,,1.0,377.92,2.0,-1.0,51.9999999999,SLD,BTC,USD,20160328 20:41:24 EST,,9500.0,-3153873.6,-3328700.0,377.92,652820.0,51.9999999999
406,Paper,Paper,9483.25,USD,BITSTAMP,406.0,,,1.0,379.33,2.0,1.0,-23583.25,BOT,BTC,USD,20160328 22:01:13 EST,,-14100.0,-3177456.85,-3328700.0,379.33,638720.0,-23583.25
407,Paper,Paper,9476.75,USD,BITSTAMP,407.0,,,1.0,379.07,2.0,-1.0,-12076.75,SLD,BTC,USD,20160328 22:11:53 EST,,-2600.0,-3189533.6,-3328700.0,379.07,636120.0,-12076.75
408,Paper,Paper,9456.45,USD,BITSTAMP,408.0,,,1.0,378.258,2.0,1.0,-1336.45,BOT,BTC,USD,20160328 23:44:46 EST,,8120.0,-3190870.05,-3328700.0,378.258,644240.0,-1336.45
409,Paper,Paper,9466.825,USD,BITSTAMP,409.0,,,1.0,378.673,2.0,-1.0,-5316.825,SLD,BTC,USD,20160328 23:56:16 EST,,4150.0,-3196186.875,-3328700.0,378.673,648390.0,-5316.825
410,Paper,Paper,9452.25,USD,BITSTAMP,410.0,,,1.0,378.09,2.0,1.0,-3622.25,BOT,BTC,USD,20160329 00:33:44 EST,,5830.0,-3199809.125,-3328700.0,378.09,654220.0,-3622.25
411,Paper,Paper,9467.9,USD,BITSTAMP,411.0,,,1.0,378.716,2.0,-1.0,-3207.9,SLD,BTC,USD,20160329 00:39:43 EST,,6260.0,-3203017.025,-3328700.0,378.716,660480.0,-3207.9
412,Paper,Paper,9437.85,USD,BITSTAMP,412.0,,,1.0,377.514,2.0,1.0,2582.15,BOT,BTC,USD,20160329 02:02:46 EST,,12020.0,-3200434.875,-3328700.0,377.514,672500.0,2582.15
413,Paper,Paper,9445.0,USD,BITSTAMP,413.0,,,1.0,377.8,2.0,-1.0,-6585.0,SLD,BTC,USD,20160329 02:09:00 EST,,2860.0,-3207019.875,-3328700.0,377.8,675360.0,-6585.0
414,Paper,Paper,9453.5,USD,BITSTAMP,414.0,,,1.0,378.14,2.0,1.0,-12853.5,BOT,BTC,USD,20160329 02:26:39 EST,,-3400.0,-3219873.375,-3328700.0,378.14,671960.0,-12853.5
415,Paper,Paper,9453.5,USD,BITSTAMP,415.0,,,1.0,378.14,2.0,-1.0,-9453.5,SLD,BTC,USD,20160329 02:32:06 EST,,0.0,-3229326.875,-3328700.0,378.14,671960.0,-9453.5
416,Paper,Paper,9469.475,USD,BITSTAMP,416.0,,,1.0,378.779,2.0,1.0,-15859.475,BOT,BTC,USD,20160329 03:07:32 EST,,-6390.0,-3245186.35,-3328700.0,378.779,665570.0,-15859.475
417,Paper,Paper,9460.0,USD,BITSTAMP,417.0,,,1.0,378.4,2.0,-1.0,-13250.0,SLD,BTC,USD,20160329 03:14:30 EST,,-3790.0,-3258436.35,-3328700.0,378.4,661780.0,-13250.0
418,Paper,Paper,9442.5,USD,BITSTAMP,418.0,,,1.0,377.7,2.0,1.0,-2442.5,BOT,BTC,USD,20160329 04:16:06 EST,,7000.0,-3260878.85,-3328700.0,377.7,668780.0,-2442.5
419,Paper,Paper,9462.275,USD,BITSTAMP,419.0,,,1.0,378.491,2.0,-1.0,-1552.275,SLD,BTC,USD,20160329 04:22:44 EST,,7910.0,-3262431.125,-3328700.0,378.491,676690.0,-1552.275
420,Paper,Paper,9443.45,USD,BITSTAMP,420.0,,,1.0,377.738,2.0,1.0,-1913.45,BOT,BTC,USD,20160329 04:36:26 EST,,7530.0,-3264344.575,-3328700.0,377.738,684220.0,-1913.45
421,Paper,Paper,9461.95,USD,BITSTAMP,421.0,,,1.0,378.478,2.0,-1.0,-2061.95,SLD,BTC,USD,20160329 04:43:17 EST,,7400.0,-3266406.525,-3328700.0,378.478,691620.0,-2061.95
422,Paper,Paper,9462.025,USD,BITSTAMP,422.0,,,1.0,378.481,2.0,1.0,-9492.025,BOT,BTC,USD,20160329 04:50:07 EST,,-29.9999999999,-3275898.55,-3328700.0,378.481,691590.0,-9492.025
423,Paper,Paper,9458.7,USD,BITSTAMP,423.0,,,1.0,378.348,2.0,-1.0,-10788.7,SLD,BTC,USD,20160329 04:56:48 EST,,-1330.0,-3286687.25,-3328700.0,378.348,690260.0,-10788.7
424,Paper,Paper,9330.5,USD,BITSTAMP,424.0,,,1.0,373.22,2.0,1.0,41949.5,BOT,BTC,USD,20160329 07:49:40 EST,,51280.0,-3244737.75,-3328700.0,373.22,741540.0,41949.5
425,Paper,Paper,9325.075,USD,BITSTAMP,425.0,,,1.0,373.003,2.0,-1.0,-11495.075,SLD,BTC,USD,20160329 07:52:42 EST,,-2170.0,-3256232.825,-3328700.0,373.003,739370.0,-11495.075
426,Paper,Paper,9220.75,USD,BITSTAMP,426.0,,,1.0,368.83,2.0,1.0,32509.25,BOT,BTC,USD,20160329 08:02:08 EST,,41730.0,-3223723.575,-3328700.0,368.83,781100.0,32509.25
427,Paper,Paper,9187.75,USD,BITSTAMP,427.0,,,1.0,367.51,2.0,-1.0,-22387.75,SLD,BTC,USD,20160329 08:08:38 EST,,-13200.0,-3246111.325,-3328700.0,367.51,767900.0,-22387.75
428,Paper,Paper,9249.025,USD,BITSTAMP,428.0,,,1.0,369.961,2.0,1.0,-33759.025,BOT,BTC,USD,20160329 09:21:27 EST,,-24510.0,-3279870.35,-3328700.0,369.961,743390.0,-33759.025
429,Paper,Paper,9235.0,USD,BITSTAMP,429.0,,,1.0,369.4,2.0,-1.0,-14845.0,SLD,BTC,USD,20160329 09:25:04 EST,,-5610.0,-3294715.35,-3328700.0,369.4,737780.0,-14845.0
430,Paper,Paper,9224.725,USD,BITSTAMP,430.0,,,1.0,368.989,2.0,1.0,-5114.725,BOT,BTC,USD,20160329 11:05:26 EST,,4110.0,-3299830.075,-3328700.0,368.989,741890.0,-5114.725
431,Paper,Paper,9240.675,USD,BITSTAMP,431.0,,,1.0,369.627,2.0,-1.0,-2860.675,SLD,BTC,USD,20160329 11:08:52 EST,,6380.0,-3302690.75,-3328700.0,369.627,748270.0,-2860.675
432,Paper,Paper,9240.325,USD,BITSTAMP,432.0,,,1.0,369.613,2.0,1.0,-9100.325,BOT,BTC,USD,20160329 11:12:16 EST,,140.0,-3311791.075,-3328700.0,369.613,748410.0,-9100.325
433,Paper,Paper,9244.975,USD,BITSTAMP,433.0,,,1.0,369.799,2.0,-1.0,-7384.975,SLD,BTC,USD,20160329 11:15:36 EST,,1860.0,-3319176.05,-3328700.0,369.799,750270.0,-7384.975
434,Paper,Paper,9209.425,USD,BITSTAMP,434.0,,,1.0,368.377,2.0,1.0,5010.575,BOT,BTC,USD,20160329 12:56:10 EST,,14220.0,-3314165.475,-3328700.0,368.377,764490.0,5010.575
435,Paper,Paper,9200.5,USD,BITSTAMP,435.0,,,1.0,368.02,2.0,-1.0,-12770.5,SLD,BTC,USD,20160329 12:59:28 EST,,-3570.0,-3326935.975,-3328700.0,368.02,760920.0,-12770.5
