permid,account,clientid,commission,commission_currency,exchange,execid,expiry,level_0,orderid,price,qty,openqty,realized_PnL,side,symbol,symbol_currency,times,yield_redemption_date,balance,margin_available,openprice
1,Paper,Paper,2.0,USD,IDEALPRO,1.0,,,1.0,1.4439,10000.0,-10000.0,-2.0,SLD,GBP,USD,20160318 06:23:55 EST,,9998.0,15561.0,1.4439
2,Paper,Paper,2.0,USD,IDEALPRO,2.0,,,1.0,1.44472,60000.0,50000.0,-10.2,BOT,GBP,USD,20160318 07:13:56 EST,,9987.8,30008.2,1.4439
3,Paper,Paper,2.0,USD,IDEALPRO,3.0,,,1.0,1.44884,40000.0,10000.0,195.6,SLD,GBP,USD,20160318 08:44:37 EST,,10183.4,87961.8,1.4439
4,Paper,Paper,2.0,USD,IDEALPRO,4.0,,,1.0,1.44776,20000.0,-10000.0,36.6,SLD,GBP,USD,20160318 15:26:12 EST,,10220.0,102439.4,1.4439
5,Paper,Paper,2.0,USD,IDEALPRO,5.0,,,1.0,1.44589,60000.0,50000.0,-21.9,BOT,GBP,USD,20160320 17:15:13 EST,,10198.1,116898.3,1.4439
6,Paper,Paper,2.0,USD,IDEALPRO,6.0,,,1.0,1.4464,60000.0,-10000.0,123.0,SLD,GBP,USD,20160320 19:21:44 EST,,10321.1,189218.3,1.4439
