permid,account,clientid,commission,commission_currency,exchange,execid,expiry,level_0,orderid,price,qty,openqty,realized_PnL,side,symbol,symbol_currency,times,yield_redemption_date,PurePL,balance,margin_available,mark_to_mkt,openprice,pure_mark_to_mkt,purebalance,real_pnl
1,Paper,Paper,2.0,USD,IDEALPRO,1.0,,,1.0,0.68092,20000.0,-20000.0,-2.0,SLD,NZD,USD,20160410 17:15:29 EST,,0.0,99998.0,1986381.6,99986.0,0.68092,99990.0,100000.0,-2.0
2,Paper,Paper,2.0,USD,IDEALPRO,2.0,,,1.0,0.6817,40000.0,20000.0,-17.6,BOT,NZD,USD,20160410 19:10:01 EST,,-15.6,99980.4,1986381.6,99971.4,0.6817,99977.4,99984.4,-17.6
3,Paper,Paper,2.0,USD,IDEALPRO,3.0,,,1.0,0.6816,40000.0,-20000.0,-4.0,SLD,NZD,USD,20160410 21:18:37 EST,,-2.0,99976.4,1986381.6,99978.0,0.6816,99986.0,99982.4,-4.0
4,Paper,Paper,2.0,USD,IDEALPRO,4.0,,,1.0,0.6817,40000.0,20000.0,-4.0,BOT,NZD,USD,20160410 21:46:19 EST,,-2.0,99972.4,1986381.6,99963.4,0.6817,99973.4,99980.4,-4.0
5,Paper,Paper,2.0,USD,IDEALPRO,5.0,,,1.0,0.6816,40000.0,-20000.0,-4.0,SLD,NZD,USD,20160410 22:14:30 EST,,-2.0,99968.4,1986381.6,99970.0,0.6816,99982.0,99978.4,-4.0
6,Paper,Paper,2.0,USD,IDEALPRO,6.0,,,1.0,0.6817,60000.0,40000.0,-4.0,BOT,NZD,USD,20160410 23:10:23 EST,,-2.0,99964.4,1972747.6,99948.4,0.6817,99962.4,99976.4,-4.0
